SEEEEEEGEGGGGSS	S E E E E E E G E G G G G S S |
SEEEGGGGGGSSGGGGGGGGGGGGGGGGGSGGS	S E E E G G G G G G S S G G G G G G G G G G G G G G G G G S G G S |
SEEGGGGGGGGSS	S E E G G G G G G G G S S |
SEEGGGGGGGSSSSS	S E E G G G G G G G S S S S S |
SGGGGGGGEGGGGSS	S G G G G G G G E G G G G S S |
SGGGGGGGGGEEGGGGGGGGGGGGGGGGGGGSSSGGGSSS	S G G G G G G G G G E E G G G G G G G G G G G G G G G G G G G S S S G G G S S S |
SGGGGGGGGGGEEEEEGGEEEEEEESGGEEEGGGGS	S G G G G G G G G G G E E E E E G G E E E E E E E S G G E E E G G G G S |
SGGGGGGGGGGEGGGGGGGGGGGGS	S G G G G G G G G G G E G G G G G G G G G G G G S |
SGGGGGGGGGGGEEEEEGGGGGGGGGSGG	S G G G G G G G G G G G E E E E E G G G G G G G G G S G G |
SGGGGGGGGGGGGGGGGEEGGGGGGGSS	S G G G G G G G G G G G G G G G G E E G G G G G G G S S |
SGGGGGGGGGGGGGGGGGGGSSSSEEEGGGG	S G G G G G G G G G G G G G G G G G G G S S S S E E E G G G G |
SGGGGGGGGGGGGGGGGGSEEEGSSSSGGGGGGGGGGGGGGGSS	S G G G G G G G G G G G G G G G G G S E E E G S S S S G G G G G G G G G G G G G G G S S |
SGGGGGGGGSGGGGGEESGGGGGSS	S G G G G G G G G S G G G G G E E S G G G G G S S |
SGGGGGGGSSSGGGGGGSGGGGGGSEEGGGGGGS	S G G G G G G G S S S G G G G G G S G G G G G G S E E G G G G G G S |
SGSGGGGGGGGGGGGGGEEEEGSGGGGGGGSS	S G S G G G G G G G G G G G G G G E E E E G S G G G G G G G S S |
SSEEEEEEEEEEEGEEEGGGGGGGGSGGGGGGGGGGGGGGGGGGGGGGGSSSSGGGGGGSS	S S E E E E E E E E E E E G E E E G G G G G G G G S G G G G G G G G G G G G G G G G G G G G G G G S S S S G G G G G G S S |
SSEEEEEEEEEGGGGGGGGSGGGGSSSSEEEEGGGGGGEEESSGGGGGGSS	S S E E E E E E E E E G G G G G G G G S G G G G S S S S E E E E G G G G G G E E E S S G G G G G G S S |
SSEEEEEEGGEEGGSSS	S S E E E E E E G G E E G G S S S |
SSEEEEEEGGGGGEGGEESSGGGGGGSS	S S E E E E E E G G G G G E G G E E S S G G G G G G S S |
SSEEEEEEGGGGGGGEGGGEEEEEEGGGGGGS	S S E E E E E E G G G G G G G E G G G E E E E E E G G G G G G S |
SSEEEEEEGGGGGGGGGGGGEEEEGGEEGGGGSGGGGGSSSS	S S E E E E E E G G G G G G G G G G G G E E E E G G E E G G G G S G G G G G S S S S |
SSEEEEEESSGGGGGGGGSS	S S E E E E E E S S G G G G G G G G S S |
SSEEEEEGGGGGGGGGGGGGGGGGS	S S E E E E E G G G G G G G G G G G G G G G G G S |
SSEEEEEGGGGGGSGGGGGGGGGGSS	S S E E E E E G G G G G G S G G G G G G G G G G S S |
SSEEEEEGGSSGGGGGGGGGSGGGGGGGGGGGSS	S S E E E E E G G S S G G G G G G G G G S G G G G G G G G G G G S S |
SSEEEEEGGSSSGGGGGGGSGGGSS	S S E E E E E G G S S S G G G G G G G S G G G S S |
SSEEEEESSSEEEGGGGGGEEGGGGGGGGGGGGGGGGGGGGGGGGGSS	S S E E E E E S S S E E E G G G G G G E E G G G G G G G G G G G G G G G G G G G G G G G G G S S |
SSEEEEGEEEEEEEGEGGGGGSS	S S E E E E G E E E E E E E G E G G G G G S S |
SSEEEEGEEGEGGGGGSS	S S E E E E G E E G E G G G G G S S |
SSEEEEGEEGGGGGGSS	S S E E E E G E E G G G G G G S S |
SSEEEEGGGGEEGGEGGGGGSS	S S E E E E G G G G E E G G E G G G G G S S |
SSEEEEGGGGEGGGGGGS	S S E E E E G G G G E G G G G G G S |
SSEEEEGGGGGGEEGGGGGGSGGGGGGGGGGGSS	S S E E E E G G G G G G E E G G G G G G S G G G G G G G G G G G S S |
SSEEEEGGGGGGGEEGGGGGGGGGGGGGGGGSEEEGGGGGSS	S S E E E E G G G G G G G E E G G G G G G G G G G G G G G G G S E E E G G G G G S S |
SSEEEEGGGGGGGGGEGGGEEGGGGGGGGGGSS	S S E E E E G G G G G G G G G E G G G E E G G G G G G G G G G S S |
SSEEEEGGGGGGGGGGGGGGGGGGGGGGGGGGGGGGGSS	S S E E E E G G G G G G G G G G G G G G G G G G G G G G G G G G G G G G G S S |
SSEEEEGGGGGGGGGGGGGGGGGGGGGGGGGGSS	S S E E E E G G G G G G G G G G G G G G G G G G G G G G G G G G S S |
SSEEEEGGGGGGGGGGGGGGGGGGGGSS	S S E E E E G G G G G G G G G G G G G G G G G G G G S S |
SSEEEEGGGGGGGGGGGGGSSSS	S S E E E E G G G G G G G G G G G G G S S S S |
SSEEEEGGGGGGGGSS	S S E E E E G G G G G G G G S S |
SSEEEEGGGGGGGSSSGGGGGGGGGEEGGGGEESSEEESSSEGGGGGGGGGS	S S E E E E G G G G G G G S S S G G G G G G G G G E E G G G G E E S S E E E S S S E G G G G G G G G G S |
SSEEEESEEGGGEEEESEEGSS	S S E E E E S E E G G G E E E E S E E G S S |
SSEEEESGGGGGGGGGGGS	S S E E E E S G G G G G G G G G G G S |
SSEEEGEEEEEEEEEGGGEEGGGGSS	S S E E E G E E E E E E E E E G G G E E G G G G S S |
SSEEEGEEEEESSGGGGGGGEEESSSGGGEGGSS	S S E E E G E E E E E S S G G G G G G G E E E S S S G G G E G G S S |
SSEEEGEGGGGGGGGGGGGGGGGGSS	S S E E E G E G G G G G G G G G G G G G G G G G S S |
SSEEEGEGGGGGGGGGGGSS	S S E E E G E G G G G G G G G G G G S S |
SSEEEGGGEEEGGGGSSGGGGGGGGGGGGEEEEGSGGGGGGGGGGSS	S S E E E G G G E E E G G G G S S G G G G G G G G G G G G E E E E G S G G G G G G G G G G S S |
SSEEEGGGEEGGGGGGGGGGGSS	S S E E E G G G E E G G G G G G G G G G G S S |
SSEEEGGGGEEEEGGEGGGGGGGGGGGSSS	S S E E E G G G G E E E E G G E G G G G G G G G G G G S S S |
SSEEEGGGGGEEEEGGGGGGGGGGGGGGGGS	S S E E E G G G G G E E E E G G G G G G G G G G G G G G G G S |
SSEEEGGGGGEESGGGGGGGGGGGGGGGGGGSS	S S E E E G G G G G E E S G G G G G G G G G G G G G G G G G G S S |
SSEEEGGGGGGGGGEEGGGGGGGSS	S S E E E G G G G G G G G G E E G G G G G G G S S |
SSEEEGGGGGGGGGGGGGGGEEGGGGGSGGGSS	S S E E E G G G G G G G G G G G G G G G E E G G G G G S G G G S S |
SSEEEGGGGGGGGGGGGGGGGGGGGEEESSEEGGGGGGSSSSSSSGGGGGGSGGGGGGGGGGSS	S S E E E G G G G G G G G G G G G G G G G G G G G E E E S S E E G G G G G G S S S S S S S G G G G G G S G G G G G G G G G G S S |
SSEEEGGGGGGGGGGGGGGGGGGGGGGGGGGGGEEEEGGGGGSS	S S E E E G G G G G G G G G G G G G G G G G G G G G G G G G G G G E E E E G G G G G S S |
SSEEEGGGGGGGGGGGGGGGGGGGGGGGGGGGGSSS	S S E E E G G G G G G G G G G G G G G G G G G G G G G G G G G G G S S S |
SSEEEGGGGGGGGGGGGGGGGGGGGGGGSS	S S E E E G G G G G G G G G G G G G G G G G G G G G G G S S |
SSEEEGGGGGGGGGGGGGGGGGGGGSS	S S E E E G G G G G G G G G G G G G G G G G G G G S S |
SSEEEGGGGGGGGGGGGGGGGGGGSSSSGGGGGGSGGGGGGGSS	S S E E E G G G G G G G G G G G G G G G G G G G S S S S G G G G G G S G G G G G G G S S |
SSEEEGGGGGGGGGGGGGGGGGGSS	S S E E E G G G G G G G G G G G G G G G G G G S S |
SSEEEGGGGGGGGGGGGGGGGS	S S E E E G G G G G G G G G G G G G G G G S |
SSEEEGGGGGGGGGGGGGGGGSSS	S S E E E G G G G G G G G G G G G G G G G S S S |
SSEEEGGGGGGGGGGGSS	S S E E E G G G G G G G G G G G S S |
SSEEEGGGGGGGGGGSS	S S E E E G G G G G G G G G G S S |
SSEEEGGGGGGGGGSSSGGGEEESGGGGGGGSSGGGEEGGGGGGGGGGGS	S S E E E G G G G G G G G G S S S G G G E E E S G G G G G G G S S G G G E E G G G G G G G G G G G S |
SSEEEGGGGGGGGSGGGGGGGGGGGGGGGGGGGSSGGGSS	S S E E E G G G G G G G G S G G G G G G G G G G G G G G G G G G G S S G G G S S |
SSEEEGGGGGGGGSGGGGGGGGGGGGSS	S S E E E G G G G G G G G S G G G G G G G G G G G G S S |
SSEEEGGGGGGGSSSSSSSSGGSSGGGGSGGGSS	S S E E E G G G G G G G S S S S S S S S G G S S G G G G S G G G S S |
SSEEEGGGGGGSSSGGGGGGGGGGGSSGGGGEEEEEEGSEEEEGGGGSS	S S E E E G G G G G G S S S G G G G G G G G G G G S S G G G G E E E E E E G S E E E E G G G G S S |
SSEEEGGGGGSEEEGGGGGEEEGGGGGEEEEGGGEEGGGGGGGGGGGSS	S S E E E G G G G G S E E E G G G G G E E E G G G G G E E E E G G G E E G G G G G G G G G G G S S |
SSEEEGGGGGSSSGGGGGGGGSSGGGGGGGGGGGGGSS	S S E E E G G G G G S S S G G G G G G G G S S G G G G G G G G G G G G G S S |
SSEEEGSGGGGGGGGGGGGGGGGGGGGGGS	S S E E E G S G G G G G G G G G G G G G G G G G G G G G G S |
SSEEEGSGGGGGGGGGSSSSSGGGGGGGS	S S E E E G S G G G G G G G G G S S S S S G G G G G G G S |
SSEEESEEEGGEEEGGGGGGGGGGSS	S S E E E S E E E G G E E E G G G G G G G G G G S S |
SSEEESEEGGGGGGGGGGGGGGGGGGGGGGGGGGSS	S S E E E S E E G G G G G G G G G G G G G G G G G G G G G G G G G G S S |
SSEEESEGGGGGGGGGGSS	S S E E E S E G G G G G G G G G G S S |
SSEEESGGGGGGGGGGEEGGGGGGGGGGGGGGGGGGS	S S E E E S G G G G G G G G G G E E G G G G G G G G G G G G G G G G G G S |
SSEEGEEEEGGGGGGGGGGSS	S S E E G E E E E G G G G G G G G G G S S |
SSEEGEEGGSGEEEEEEGGGGSGGEESGGGSGSS	S S E E G E E G G S G E E E E E E G G G G S G G E E S G G G S G S S |
SSEEGEGGGGGGGGEEEEEEGSSEEGGGGGGSS	S S E E G E G G G G G G G G E E E E E E G S S E E G G G G G G S S |
SSEEGGGEEGGGGGGGGGGSS	S S E E G G G E E G G G G G G G G G G S S |
SSEEGGGGEEGGGGGGGS	S S E E G G G G E E G G G G G G G S |
SSEEGGGGGEEGGGGGGEEGGGGGGGGGGGGGGGGGGGSS	S S E E G G G G G E E G G G G G G E E G G G G G G G G G G G G G G G G G G G S S |
SSEEGGGGGGGEEEEESSSSSSSGGGGSSSGGGGGEEGEEESEEEEESGGGGSGGGGGGGGGGGS	S S E E G G G G G G G E E E E E S S S S S S S G G G G S S S G G G G G E E G E E E S E E E E E S G G G G S G G G G G G G G G G G S |
SSEEGGGGGGGGGGGGGGGGGGGGGGGGGGGS	S S E E G G G G G G G G G G G G G G G G G G G G G G G G G G G S |
SSEEGGGGGGGGGGGGGGGGGGGGGSGGGGGGGGGGGGGGGGGGS	S S E E G G G G G G G G G G G G G G G G G G G G G S G G G G G G G G G G G G G G G G G G S |
SSEEGGGGGGGGGGGGGGGGGGGSS	S S E E G G G G G G G G G G G G G G G G G G G S S |
SSEEGGGGGGGGGGGGS	S S E E G G G G G G G G G G G G S |
SSEEGGGGGGGGGGGGSSS	S S E E G G G G G G G G G G G G S S S |
SSEEGGGGGGGGGGGS	S S E E G G G G G G G G G G G S |
SSEEGGGGGGGGGGSS	S S E E G G G G G G G G G G S S |
SSEEGGGGGGGGGGSSSGGGGGGGGGGGGGGEGGEEEGGGGGGS	S S E E G G G G G G G G G G S S S G G G G G G G G G G G G G G E G G E E E G G G G G G S |
SSEEGGGGGGGGGSGGGSSGGGGGGGGGGGSGGEGGGGGGSS	S S E E G G G G G G G G G S G G G S S G G G G G G G G G G G S G G E G G G G G G S S |
SSEEGGGGGGGGGSSSSGGGGGGGGGGGGGSGGGGGGGSS	S S E E G G G G G G G G G S S S S G G G G G G G G G G G G G S G G G G G G G S S |
SSEEGGGGGGGGSGGGSEEEGGGGGGGGGSSGGGGSS	S S E E G G G G G G G G S G G G S E E E G G G G G G G G G S S G G G G S S |
SSEEGGGGGGGSSGGGGGGGGGSS	S S E E G G G G G G G S S G G G G G G G G G S S |
SSEEGGGGGGSEEEGSGGGSSSSSGGGGSSGGGGGGSSSSSSGGGGGGSS	S S E E G G G G G G S E E E G S G G G S S S S S G G G G S S G G G G G G S S S S S S G G G G G G S S |
SSEEGGGGGGSSGGGGGGGGGGGGGEEEGGGGGEEGGGGGGGGGSS	S S E E G G G G G G S S G G G G G G G G G G G G G E E E G G G G G E E G G G G G G G G G S S |
SSEEGGGGSSGGEEGGGGGGSGGSS	S S E E G G G G S S G G E E G G G G G G S G G S S |
SSEEGGGSGGGEEEEGGGGGGGGEEGGGGSS	S S E E G G G S G G G E E E E G G G G G G G G E E G G G G S S |
SSEEGGGSGGGSSS	S S E E G G G S G G G S S S |
SSEEGGGSSSGGGGGGGEEEGGGGGGGSS	S S E E G G G S S S G G G G G G G E E E G G G G G G G S S |
SSEEGGGSSSGGGGGGGGSS	S S E E G G G S S S G G G G G G G G S S |
SSEEGSGGGGGGGGGGGEEGGGGGGSSGGGGSGGGGSS	S S E E G S G G G G G G G G G G G E E G G G G G G S S G G G G S G G G G S S |
SSEESEEEEESGGGGGGGGGGGGGGGSGGGGGG	S S E E S E E E E E S G G G G G G G G G G G G G G G S G G G G G G |
SSEESGGGEEGGGGGSSSGGGGGGGGGGGGGSSS	S S E E S G G G E E G G G G G S S S G G G G G G G G G G G G G S S S |
SSEGGGGGGGEEEEEGEEGGGGGGGGGGGGGGGEEEGGGGGGGGGGGSS	S S E G G G G G G G E E E E E G E E G G G G G G G G G G G G G G G E E E G G G G G G G G G G G S S |
SSEGSGGGGGGSS	S S E G S G G G G G G S S |
SSGEEEEEGGGGEEEGGSGGGSGGGGGGGGGGGSS	S S G E E E E E G G G G E E E G G S G G G S G G G G G G G G G G G S S |
SSGEEEEEGGGGGGGGSGGGGGGSGGGGS	S S G E E E E E G G G G G G G G S G G G G G G S G G G G S |
SSGEEEEESEEGGGGGGGGGSS	S S G E E E E E S E E G G G G G G G G G S S |
SSGEEGGGGEEGGGGGSSS	S S G E E G G G G E E G G G G G S S S |
SSGEEGGGGGEEGGGGSGGGGGS	S S G E E G G G G G E E G G G G S G G G G G S |
SSGEESGGGGGGGEEGGGGGGSS	S S G E E S G G G G G G G E E G G G G G G S S |
SSGGEEEEEEEEEEGGSSEEEEEEEEEEEGGGGSGGSSGGGGGGGGGSS	S S G G E E E E E E E E E E G G S S E E E E E E E E E E E G G G G S G G S S G G G G G G G G G S S |
SSGGEEEEEEEGGGGGGGGGGGS	S S G G E E E E E E E G G G G G G G G G G G S |
SSGGEEEEEEEGGGGGGGGSS	S S G G E E E E E E E G G G G G G G G S S |
SSGGEEEEEEEGGGGGGSSGGGGGGGGSS	S S G G E E E E E E E G G G G G G S S G G G G G G G G S S |
SSGGEEEEEGGGGGGSS	S S G G E E E E E G G G G G G S S |
SSGGEEEEGEEGGGGGGGGGGGGGGGGGGGGGS	S S G G E E E E G E E G G G G G G G G G G G G G G G G G G G G G S |
SSGGEEEEGGGGGGGEGGGGGGS	S S G G E E E E G G G G G G G E G G G G G G S |
SSGGEEEEGGGGGGGGGGGGGS	S S G G E E E E G G G G G G G G G G G G G S |
SSGGEEEGGGEEESGGGGGEGGGGGGGS	S S G G E E E G G G E E E S G G G G G E G G G G G G G S |
SSGGEEEGGGGGGGGGGGGGGGGGGGGGGGGGGSSSGGGGGGGGGGGGGGGS	S S G G E E E G G G G G G G G G G G G G G G G G G G G G G G G G G S S S G G G G G G G G G G G G G G G S |
SSGGEEEGGGGGSGGGGGGGGGSS	S S G G E E E G G G G G S G G G G G G G G G S S |
SSGGEEEGGSEEEEEEEGGGSGGGGS	S S G G E E E G G S E E E E E E E G G G S G G G G S |
SSGGEEGEEGGGGGGGGGEEEGGSS	S S G G E E G E E G G G G G G G G G E E E G G S S |
SSGGEEGGGEESSGGGGGGGEEGGGGGGGGGSGGGGGGGS	S S G G E E G G G E E S S G G G G G G G E E G G G G G G G G G S G G G G G G G S |
SSGGEEGGGGGGEEGGGEEGGGGGGGGGGGGGGGGS	S S G G E E G G G G G G E E G G G E E G G G G G G G G G G G G G G G G S |
SSGGEEGGGGGGGGGGGGGGGGGGGGGGGGGGGGGGGGGGSS	S S G G E E G G G G G G G G G G G G G G G G G G G G G G G G G G G G G G G G G G S S |
SSGGEEGGGGGGGGGGGGGGGGGGGGGGGGGSGGGGGGGGGSS	S S G G E E G G G G G G G G G G G G G G G G G G G G G G G G G S G G G G G G G G G S S |
SSGGEEGGGGGGGGGGGGGGGGGGGGGGGGGSS	S S G G E E G G G G G G G G G G G G G G G G G G G G G G G G G S S |
SSGGEEGGGGGGGGGGGGGGGGGGGGGGSS	S S G G E E G G G G G G G G G G G G G G G G G G G G G G S S |
SSGGEEGGGGGGGGGGGGGGGGGGS	S S G G E E G G G G G G G G G G G G G G G G G G S |
SSGGEEGGGGGGGGGGGGGGGGGSS	S S G G E E G G G G G G G G G G G G G G G G G S S |
SSGGEEGGGGGGGGGGGGGGS	S S G G E E G G G G G G G G G G G G G G S |
SSGGEEGGGGGGGGGGGSS	S S G G E E G G G G G G G G G G G S S |
SSGGEEGGGGGGGGGGGSSSS	S S G G E E G G G G G G G G G G G S S S S |
SSGGEEGGGGGGSSGGGGGGGSGGGGGGGGGGSSGGGGSSS	S S G G E E G G G G G G S S G G G G G G G S G G G G G G G G G G S S G G G G S S S |
SSGGEEGGGGSEEEEEGEEGGGGGGGGGGGGSS	S S G G E E G G G G S E E E E E G E E G G G G G G G G G G G G S S |
SSGGEEGGGGSGGGGGGGGGGGGGGGGGGSS	S S G G E E G G G G S G G G G G G G G G G G G G G G G G G S S |
SSGGEEGGGGSGGGGGGGSS	S S G G E E G G G G S G G G G G G G S S |
SSGGEEGGGSGGGGGSS	S S G G E E G G G S G G G G G S S |
SSGGEEGSGGGGGGGSSSS	S S G G E E G S G G G G G G G S S S S |
SSGGEESSGGGGGGEGGGGGGGGGGGGGGGGGGGGGGGSS	S S G G E E S S G G G G G G E G G G G G G G G G G G G G G G G G G G G G G G S S |
SSGGEGGGGGGEEEEGGEEEEGGGGGGSS	S S G G E G G G G G G E E E E G G E E E E G G G G G G S S |
SSGGEGGGGGGGGEGEGGGEEEGGS	S S G G E G G G G G G G G E G E G G G E E E G G S |
SSGGEGGGGGGGGGGGGGGGGGGGGGGGGGGGGSS	S S G G E G G G G G G G G G G G G G G G G G G G G G G G G G G G G S S |
SSGGEGGGGGGGGGGGGGGGGGGGGS	S S G G E G G G G G G G G G G G G G G G G G G G G S |
SSGGEGGGGGGGGGGGGGGGGGSSSSS	S S G G E G G G G G G G G G G G G G G G G G S S S S S |
SSGGEGGGGGGGGGGGGGGS	S S G G E G G G G G G G G G G G G G G S |
SSGGEGGGGGGGGGGGGGSS	S S G G E G G G G G G G G G G G G G S S |
SSGGEGGGGGGGGGGGSS	S S G G E G G G G G G G G G G G S S |
SSGGEGGGGGGGGGGSGGGGGGGGGGGGGSGGGGGGGSS	S S G G E G G G G G G G G G G S G G G G G G G G G G G G G S G G G G G G G S S |
SSGGEGGGGGGGGGSSEEGGGGGSS	S S G G E G G G G G G G G G S S E E G G G G G S S |
SSGGGEEEEEGEGGGSSS	S S G G G E E E E E G E G G G S S S |
SSGGGEEEEEGGGEEGGGSS	S S G G G E E E E E G G G E E G G G S S |
SSGGGEEEEEGSSSGGGGGGGGGGGSGGGGGGGG	S S G G G E E E E E G S S S G G G G G G G G G G G S G G G G G G G G |
SSGGGEEEEESGGGGGSGGGGGGGGGS	S S G G G E E E E E S G G G G G S G G G G G G G G G S |
SSGGGEEEEESSSSSSSSSGGGSSEEEEESSEEEGGGGGGGGGGGGGGGGGGGSS	S S G G G E E E E E S S S S S S S S S G G G S S E E E E E S S E E E G G G G G G G G G G G G G G G G G G G S S |
SSGGGEEEEGGGGGGGSS	S S G G G E E E E G G G G G G G S S |
SSGGGEEEEGSSSSEGSSSSS	S S G G G E E E E G S S S S E G S S S S S |
SSGGGEEEGGEEEGGGGGGGGGGGGGGGEEEEEEGGEEGGGGGSS	S S G G G E E E G G E E E G G G G G G G G G G G G G G G E E E E E E G G E E G G G G G S S |
SSGGGEEEGGGEGGGGEEGGGGGGGGGGGS	S S G G G E E E G G G E G G G G E E G G G G G G G G G G G S |
SSGGGEEEGGGGGEGGGGGGGGGGGGGGGGGGGGGS	S S G G G E E E G G G G G E G G G G G G G G G G G G G G G G G G G G G S |
SSGGGEEEGGGGGGGGGGGEEGGGGGGSSGGGGGGGGEEGGGGGSS	S S G G G E E E G G G G G G G G G G G E E G G G G G G S S G G G G G G G G E E G G G G G S S |
SSGGGEEEGGGGGGGGGGGGGGSGGGGGS	S S G G G E E E G G G G G G G G G G G G G G S G G G G G S |
SSGGGEEEGGGGGGGSS	S S G G G E E E G G G G G G G S S |
SSGGGEEESSGGGGGGGGSSSSGGGGGGGGGGGGGSSSSGGGGGGGGGEEEGEEEEGGGGGGGGSS	S S G G G E E E S S G G G G G G G G S S S S G G G G G G G G G G G G G S S S S G G G G G G G G G E E E G E E E E G G G G G G G G S S |
SSGGGEEGGGGGGGGGEEEESGGSGGGEEGGSSS	S S G G G E E G G G G G G G G G E E E E S G G S G G G E E G G S S S |
SSGGGEEGGGGGGGGGGGGGGGGGGGGGSS	S S G G G E E G G G G G G G G G G G G G G G G G G G G G S S |
SSGGGEEGGGGGGGGGGGGGGGGGGGGS	S S G G G E E G G G G G G G G G G G G G G G G G G G G S |
SSGGGEEGGGGGGGGGGGGGGGGGGGGSS	S S G G G E E G G G G G G G G G G G G G G G G G G G G S S |
SSGGGEEGGGGGGGGGGGGGGGSS	S S G G G E E G G G G G G G G G G G G G G G S S |
SSGGGEEGGGGGGGGGGS	S S G G G E E G G G G G G G G G G S |
SSGGGEEGGGGGGGSGGGGGGGGGGGGGGGGGGGGGGSS	S S G G G E E G G G G G G G S G G G G G G G G G G G G G G G G G G G G G G S S |
SSGGGEEGGSSGGGGGGGGGEEEEEESGGGGEEGGGGGGGGGGGGGGSS	S S G G G E E G G S S G G G G G G G G G E E E E E E S G G G G E E G G G G G G G G G G G G G G S S |
SSGGGEESSSSSSGGGGGGGGGGGGGSS	S S G G G E E S S S S S S G G G G G G G G G G G G G S S |
SSGGGEGGGGEEEEESSSGGGGS	S S G G G E G G G G E E E E E S S S G G G G S |
SSGGGEGGGGGGEEEGGGGSSSSSSEEGGGGESSEGGGGSS	S S G G G E G G G G G G E E E G G G G S S S S S S E E G G G G E S S E G G G G S S |
SSGGGEGGGGGGGGEEGGGGGSS	S S G G G E G G G G G G G G E E G G G G G S S |
SSGGGEGGGGGGGGGGGGGGGS	S S G G G E G G G G G G G G G G G G G G G S |
SSGGGEGGGGGGGGSGGGGGGGSSSS	S S G G G E G G G G G G G G S G G G G G G G S S S S |
SSGGGEGGGGGGSGGGSS	S S G G G E G G G G G G S G G G S S |
SSGGGEGGGSGGGGGGGGGSSGGGGSS	S S G G G E G G G S G G G G G G G G G S S G G G G S S |
SSGGGEGGGSSSGGGGGGGEGGGGGSSS	S S G G G E G G G S S S G G G G G G G E G G G G G S S S |
SSGGGEGSEESEGGGGGGGGGGGGGGGGGGGSS	S S G G G E G S E E S E G G G G G G G G G G G G G G G G G G G S S |
SSGGGGEEEEEGGGGGGGGGGGGGGGGGGSS	S S G G G G E E E E E G G G G G G G G G G G G G G G G G G S S |
SSGGGGEEEEEGGGGGGGGGGGGGGSS	S S G G G G E E E E E G G G G G G G G G G G G G G S S |
SSGGGGEEEEEGGSSSGGGGGGGGSS	S S G G G G E E E E E G G S S S G G G G G G G G S S |
SSGGGGEEEEEGSGGGGGGGGGGGGGSS	S S G G G G E E E E E G S G G G G G G G G G G G G G S S |
SSGGGGEEEEESSGGGGGGGGEEGGGGGGGGEGGGGS	S S G G G G E E E E E S S G G G G G G G G E E G G G G G G G G E G G G G S |
SSGGGGEEEEGGEGSGEEEGSEEEEEEGGGGGGS	S S G G G G E E E E G G E G S G E E E G S E E E E E E G G G G G G S |
SSGGGGEEEEGGGEEEEGGGGGS	S S G G G G E E E E G G G E E E E G G G G G S |
SSGGGGEEEEGGGGGGGGGGGGGGGSS	S S G G G G E E E E G G G G G G G G G G G G G G G S S |
SSGGGGEEEEGGGGGGGGGSS	S S G G G G E E E E G G G G G G G G G S S |
SSGGGGEEEEGGGSSSGGGGEEEGGGGGGGSS	S S G G G G E E E E G G G S S S G G G G E E E G G G G G G G S S |
SSGGGGEEEGGGGGGEEEEEGGGGGGGGGGSS	S S G G G G E E E G G G G G G E E E E E G G G G G G G G G G S S |
SSGGGGEEEGGGGGGGEEGGGGGGGGGS	S S G G G G E E E G G G G G G G E E G G G G G G G G G S |
SSGGGGEEEGGGGGGGGGGGGS	S S G G G G E E E G G G G G G G G G G G G S |
SSGGGGEEEGGGGGGGGGGGGSS	S S G G G G E E E G G G G G G G G G G G G S S |
SSGGGGEEEGGGGGGGGSSSS	S S G G G G E E E G G G G G G G G S S S S |
SSGGGGEEEGGGSGGGGGSGGGGGGGSSSSGGGGGGGGSS	S S G G G G E E E G G G S G G G G G S G G G G G G G S S S S G G G G G G G G S S |
SSGGGGEEEGGGSSSGGGGGGGGGGGGGGGGGGSS	S S G G G G E E E G G G S S S G G G G G G G G G G G G G G G G G G S S |
SSGGGGEEESGGGGGGSS	S S G G G G E E E S G G G G G G S S |
SSGGGGEEESS	S S G G G G E E E S S |
SSGGGGEEESSGGGGGGGGGGGGEGGGGGGGGGGS	S S G G G G E E E S S G G G G G G G G G G G G E G G G G G G G G G G S |
SSGGGGEEESSSSGGGGGSGGGGGGGGGGS	S S G G G G E E E S S S S G G G G G S G G G G G G G G G G S |
SSGGGGEEGEEEGGSSGGGGGGEEGGGGGSS	S S G G G G E E G E E E G G S S G G G G G G E E G G G G G S S |
SSGGGGEEGGEEEEGSS	S S G G G G E E G G E E E E G S S |
SSGGGGEEGGGGGGEEEGGGGSGGGGGGGGGGGSS	S S G G G G E E G G G G G G E E E G G G G S G G G G G G G G G G G S S |
SSGGGGEEGGGGGGEEGGGGGGSS	S S G G G G E E G G G G G G E E G G G G G G S S |
SSGGGGEEGGGGGGEGGGGGGGGGS	S S G G G G E E G G G G G G E G G G G G G G G G S |
SSGGGGEEGGGGGGGGGEEEEGGGGGGSSGGGGGGGGGGGS	S S G G G G E E G G G G G G G G G E E E E G G G G G G S S G G G G G G G G G G G S |
SSGGGGEEGGGGGGGGGGGGGGGGGGGSS	S S G G G G E E G G G G G G G G G G G G G G G G G G G S S |
SSGGGGEEGGGGGGGGGGGGGGGGGS	S S G G G G E E G G G G G G G G G G G G G G G G G S |
SSGGGGEEGGGGGGGGGGGGGGGGSSGGGGEEEEGGGGGGGGGGSS	S S G G G G E E G G G G G G G G G G G G G G G G S S G G G G E E E E G G G G G G G G G G S S |
SSGGGGEEGGGGGGGGGGGGSSS	S S G G G G E E G G G G G G G G G G G G S S S |
SSGGGGEEGGGGGGGGGGGSSSSSGGGGGGGGGGGGGGGGGGS	S S G G G G E E G G G G G G G G G G G S S S S S G G G G G G G G G G G G G G G G G G S |
SSGGGGEEGGGGGGGGGGSS	S S G G G G E E G G G G G G G G G G S S |
SSGGGGEEGGGGGGGGSSGGGGGGGSS	S S G G G G E E G G G G G G G G S S G G G G G G G S S |
SSGGGGEEGGGGGGGS	S S G G G G E E G G G G G G G S |
SSGGGGEEGGGGGGGSSGGGGGGGGGGGGGGGGGGGGGGSS	S S G G G G E E G G G G G G G S S G G G G G G G G G G G G G G G G G G G G G G S S |
SSGGGGEEGGGGGGS	S S G G G G E E G G G G G G S |
SSGGGGEEGGSEEGGGGGGGGGEEGGGGGGGGSS	S S G G G G E E G G S E E G G G G G G G G G E E G G G G G G G G S S |
SSGGGGEESSGGGGGGGSSSSGGGGGSGGGGGSGGGGGGGGGGEEEEEESGGGGGGGGGGGSS	S S G G G G E E S S G G G G G G G S S S S G G G G G S G G G G G S G G G G G G G G G G E E E E E E S G G G G G G G G G G G S S |
SSGGGGEESSSSEEEEEGEEGGGGGGGGGGGGGS	S S G G G G E E S S S S E E E E E G E E G G G G G G G G G G G G G S |
SSGGGGEGEEGGGGGGGGGGGGGSS	S S G G G G E G E E G G G G G G G G G G G G G S S |
SSGGGGEGGEEEEGGGGSGGGGGSS	S S G G G G E G G E E E E G G G G S G G G G G S S |
SSGGGGEGGGGGGGGGGGGGGGGGGGGGGGGGGGGGGSS	S S G G G G E G G G G G G G G G G G G G G G G G G G G G G G G G G G G G G S S |
SSGGGGEGGGGGGGGGGGGGGS	S S G G G G E G G G G G G G G G G G G G G S |
SSGGGGEGGGGGGGGGS	S S G G G G E G G G G G G G G G S |
SSGGGGEGGGGGGGS	S S G G G G E G G G G G G G S |
SSGGGGGEEEEEEEGGGGGGGGGS	S S G G G G G E E E E E E E G G G G G G G G G S |
SSGGGGGEEEEEEESEEEGGSGGGGGGGGGGGGGGGGGGGGS	S S G G G G G E E E E E E E S E E E G G S G G G G G G G G G G G G G G G G G G G G S |
SSGGGGGEEEEEGGGEEGGGGGGSS	S S G G G G G E E E E E G G G E E G G G G G G S S |
SSGGGGGEEEEEGGGGGGGGS	S S G G G G G E E E E E G G G G G G G G S |
SSGGGGGEEEEEGGGGGGSSSGGGGGGGGGGGGGGGEEGGGGGGSEESESEEGGSGGGGGGGGGGSS	S S G G G G G E E E E E G G G G G G S S S G G G G G G G G G G G G G G G E E G G G G G G S E E S E S E E G G S G G G G G G G G G G S S |
SSGGGGGEEEEEGSGGGGGEEEGEEEEEEGGGEEEGGGGGGGGGGGGGGSS	S S G G G G G E E E E E G S G G G G G E E E G E E E E E E G G G E E E G G G G G G G G G G G G G G S S |
SSGGGGGEEEEGGGGGGGGGGGGGS	S S G G G G G E E E E G G G G G G G G G G G G G S |
SSGGGGGEEEEGGGGGGSSSGGGGGSS	S S G G G G G E E E E G G G G G G S S S G G G G G S S |
SSGGGGGEEEGGGGGEEEEGGGS	S S G G G G G E E E G G G G G E E E E G G G S |
SSGGGGGEEEGGGGGGGGGEEGGEEGGGSGGGEEEEGGGSS	S S G G G G G E E E G G G G G G G G G E E G G E E G G G S G G G E E E E G G G S S |
SSGGGGGEEEGGGGGGGGGGGGGGGGGGGGGGGSGGGGGGGGGGSS	S S G G G G G E E E G G G G G G G G G G G G G G G G G G G G G G G S G G G G G G G G G G S S |
SSGGGGGEEEGGGGGGGGGSS	S S G G G G G E E E G G G G G G G G G S S |
SSGGGGGEEEGGGGGSGGGGGGGS	S S G G G G G E E E G G G G G S G G G G G G G S |
SSGGGGGEEEGGGGGSSGGGGGGGGGGGGGGGSS	S S G G G G G E E E G G G G G S S G G G G G G G G G G G G G G G S S |
SSGGGGGEEEGGGGSSS	S S G G G G G E E E G G G G S S S |
SSGGGGGEEEGSSEEESEEGGGGGGGGGSS	S S G G G G G E E E G S S E E E S E E G G G G G G G G G S S |
SSGGGGGEEGGEGGGGGGSS	S S G G G G G E E G G E G G G G G G S S |
SSGGGGGEEGGGEGGEEGGGGGGGGSS	S S G G G G G E E G G G E G G E E G G G G G G G G S S |
SSGGGGGEEGGGGGGGGGGGGGGGGGGGGGGGSSSSGGGGGGSS	S S G G G G G E E G G G G G G G G G G G G G G G G G G G G G G G S S S S G G G G G G S S |
SSGGGGGEEGGGGGGGGSS	S S G G G G G E E G G G G G G G G S S |
SSGGGGGEEGGGGGGGSS	S S G G G G G E E G G G G G G G S S |
SSGGGGGEEGGGGGGSSGGGGGSS	S S G G G G G E E G G G G G G S S G G G G G S S |
SSGGGGGEEGGGSSSSS	S S G G G G G E E G G G S S S S S |
SSGGGGGEESSEEEGGGGGGGSSGGGGGGGGGGGGGGGGGSS	S S G G G G G E E S S E E E G G G G G G G S S G G G G G G G G G G G G G G G G G S S |
SSGGGGGEGGGGGGGGGGSSGGGGGGGSS	S S G G G G G E G G G G G G G G G G S S G G G G G G G S S |
SSGGGGGEGGGGSSS	S S G G G G G E G G G G S S S |
SSGGGGGEGGGSEEGGGGGGGSS	S S G G G G G E G G G S E E G G G G G G G S S |
SSGGGGGGEEEEEEGGGGGGGGGGGGGGGGGGGGGGGGSS	S S G G G G G G E E E E E E G G G G G G G G G G G G G G G G G G G G G G G G S S |
SSGGGGGGEEEEEEGGGGGGGGSSGGGGSSSGGGGGGGGGGGGGSS	S S G G G G G G E E E E E E G G G G G G G G S S G G G G S S S G G G G G G G G G G G G G S S |
SSGGGGGGEEEEGGGGGGGGGGGGGGGGGGGGGGSGGGGGGGS	S S G G G G G G E E E E G G G G G G G G G G G G G G G G G G G G G G S G G G G G G G S |
SSGGGGGGEEEEGGGGGGGGGGGGGGGGGSSSS	S S G G G G G G E E E E G G G G G G G G G G G G G G G G G S S S S |
SSGGGGGGEEEEGGGSGGGGGGGSGGGGSSSSSS	S S G G G G G G E E E E G G G S G G G G G G G S G G G G S S S S S S |
SSGGGGGGEEEESSSSEEGGGSSGGGGGGEEEEEEEGGGGGGGGGGGGGGGGGGSS	S S G G G G G G E E E E S S S S E E G G G S S G G G G G G E E E E E E E G G G G G G G G G G G G G G G G G G S S |
SSGGGGGGEEEGGGGGGEEEGGGSGGGGGGGGGS	S S G G G G G G E E E G G G G G G E E E G G G S G G G G G G G G G S |
SSGGGGGGEEEGGGGGGGGGGGGGGGGGGGGGGSSSSGGGGGGGGS	S S G G G G G G E E E G G G G G G G G G G G G G G G G G G G G G G S S S S G G G G G G G G S |
SSGGGGGGEEEGGGGGGGGGGGGGGSSSSS	S S G G G G G G E E E G G G G G G G G G G G G G G S S S S S |
SSGGGGGGEEEGGGGSS	S S G G G G G G E E E G G G G S S |
SSGGGGGGEEGEEEGGGSS	S S G G G G G G E E G E E E G G G S S |
SSGGGGGGEEGGGGGGGEESGGGGGGGSS	S S G G G G G G E E G G G G G G G E E S G G G G G G G S S |
SSGGGGGGEEGGGGGGGGGGGGGGGGGS	S S G G G G G G E E G G G G G G G G G G G G G G G G G S |
SSGGGGGGEEGGGGGGGGGGGGGGSS	S S G G G G G G E E G G G G G G G G G G G G G G S S |
SSGGGGGGEEGGGSSSGGGGSGGGGGGGGEGGGGGGGS	S S G G G G G G E E G G G S S S G G G G S G G G G G G G G E G G G G G G G S |
SSGGGGGGEEGGSEEEGGGGGGGGGGEGGGGGGGGGGGGS	S S G G G G G G E E G G S E E E G G G G G G G G G G E G G G G G G G G G G G G S |
SSGGGGGGEGEEGGGGGGGGGGGGGGSS	S S G G G G G G E G E E G G G G G G G G G G G G G G S S |
SSGGGGGGEGGEEEGGGGGGGGGGGGGGGGGS	S S G G G G G G E G G E E E G G G G G G G G G G G G G G G G G S |
SSGGGGGGEGGGGGEEEEEGGGGGGGSS	S S G G G G G G E G G G G G E E E E E G G G G G G G S S |
SSGGGGGGEGGGGGEEEGGGGGGGGGGGSSSGGGGGGGGGGGS	S S G G G G G G E G G G G G E E E G G G G G G G G G G G S S S G G G G G G G G G G G S |
SSGGGGGGEGGGGGGGGGGGGGGGGGGSS	S S G G G G G G E G G G G G G G G G G G G G G G G G G S S |
SSGGGGGGEGGGGGGGGGGGGGSS	S S G G G G G G E G G G G G G G G G G G G G S S |
SSGGGGGGEGGGGGGGGGGGSS	S S G G G G G G E G G G G G G G G G G G S S |
SSGGGGGGEGGGGGSSGGSS	S S G G G G G G E G G G G G S S G G S S |
SSGGGGGGEGGGSS	S S G G G G G G E G G G S S |
SSGGGGGGGEEEEEEEEEEGGEEEEESGGGSSSSGGGGGGGSSGGGGGGGGGSSSSSSSSGGGGSGGGGGGGGGGGGS	S S G G G G G G G E E E E E E E E E E G G E E E E E S G G G S S S S G G G G G G G S S G G G G G G G G G S S S S S S S S G G G G S G G G G G G G G G G G G S |
SSGGGGGGGEEEEEEEEGGGGGGGGGGGGGGGGGGGGGEEGGGS	S S G G G G G G G E E E E E E E E G G G G G G G G G G G G G G G G G G G G G E E G G G S |
SSGGGGGGGEEEEEEGGGGGGEEGGGGGGGGGGGSS	S S G G G G G G G E E E E E E G G G G G G E E G G G G G G G G G G G S S |
SSGGGGGGGEEEEEGSGGGGGGGGGGSS	S S G G G G G G G E E E E E G S G G G G G G G G G G S S |
SSGGGGGGGEEEEGEEEGGGGGGGGSS	S S G G G G G G G E E E E G E E E G G G G G G G G S S |
SSGGGGGGGEEEEGGEESSEEEEEGGGGGGGGGGGGGS	S S G G G G G G G E E E E G G E E S S E E E E E G G G G G G G G G G G G G S |
SSGGGGGGGEEEEGGGGGGGGGGGGGGGGGGGGGGGGGGGGGGGGGGGGGGGGGGGGGGGSS	S S G G G G G G G E E E E G G G G G G G G G G G G G G G G G G G G G G G G G G G G G G G G G G G G G G G G G G G G G G G S S |
SSGGGGGGGEEEEGGGGGGGGGGGGGSS	S S G G G G G G G E E E E G G G G G G G G G G G G G S S |
SSGGGGGGGEEEGGGGGGGGGGGGGGGGGGGGGGGSS	S S G G G G G G G E E E G G G G G G G G G G G G G G G G G G G G G G G S S |
SSGGGGGGGEEEGGGGGGGGGGGGGGGGGSSS	S S G G G G G G G E E E G G G G G G G G G G G G G G G G G S S S |
SSGGGGGGGEEEGGGGGGGGGGGGGGGSS	S S G G G G G G G E E E G G G G G G G G G G G G G G G S S |
SSGGGGGGGEEEGGGGGGGSSSSGGGGGGGGSSS	S S G G G G G G G E E E G G G G G G G S S S S G G G G G G G G S S S |
SSGGGGGGGEEEGSSSGGGGGGGGSS	S S G G G G G G G E E E G S S S G G G G G G G G S S |
SSGGGGGGGEEGGEEEEGGGGGSS	S S G G G G G G G E E G G E E E E G G G G G S S |
SSGGGGGGGEEGGGGGGGGGGGEGGEEGGGGGGSSS	S S G G G G G G G E E G G G G G G G G G G G E G G E E G G G G G G S S S |
SSGGGGGGGEEGGGGGGGGGGGGGGGGGGGGGEEGGGGGGGGSS	S S G G G G G G G E E G G G G G G G G G G G G G G G G G G G G G E E G G G G G G G G S S |
SSGGGGGGGEEGGGGGGGGGGGGGGGGGGGGGGGGGGGGGSS	S S G G G G G G G E E G G G G G G G G G G G G G G G G G G G G G G G G G G G G G S S |
SSGGGGGGGEEGGGGGGGGGGGGGGGGS	S S G G G G G G G E E G G G G G G G G G G G G G G G G S |
SSGGGGGGGEEGGGGGGGGGGGSS	S S G G G G G G G E E G G G G G G G G G G G S S |
SSGGGGGGGEEGGGGGGGGGSS	S S G G G G G G G E E G G G G G G G G G S S |
SSGGGGGGGEEGGGGGGGSS	S S G G G G G G G E E G G G G G G G S S |
SSGGGGGGGEEGGGGGSSGGGGGGGGGS	S S G G G G G G G E E G G G G G S S G G G G G G G G G S |
SSGGGGGGGEEGSGGGSEGGGEGGGGSS	S S G G G G G G G E E G S G G G S E G G G E G G G G S S |
SSGGGGGGGEGGEEGGGGGGGGGGSS	S S G G G G G G G E G G E E G G G G G G G G G G S S |
SSGGGGGGGEGGGGGGEEEG	S S G G G G G G G E G G G G G G E E E G |
SSGGGGGGGEGGGGGGGGGGGGGGGGGGS	S S G G G G G G G E G G G G G G G G G G G G G G G G G G S |
SSGGGGGGGEGGGGGGGGGGSSSSSS	S S G G G G G G G E G G G G G G G G G G S S S S S S |
SSGGGGGGGEGGGGGGGSSGGGGGGGSS	S S G G G G G G G E G G G G G G G S S G G G G G G G S S |
SSGGGGGGGGEEEEEEEEEEEEEGGGGGGGS	S S G G G G G G G G E E E E E E E E E E E E E G G G G G G G S |
SSGGGGGGGGEEEEEGGGGGEEEGGGGSGGEEEEEEGGGGGSS	S S G G G G G G G G E E E E E G G G G G E E E G G G G S G G E E E E E E G G G G G S S |
SSGGGGGGGGEEEGGGGEEEEEEEEESGGGGGGGGGSS	S S G G G G G G G G E E E G G G G E E E E E E E E E S G G G G G G G G G S S |
SSGGGGGGGGEEEGGGGGGGGGGGGGGGGGGGGGGGGSGGGGGGGGGSS	S S G G G G G G G G E E E G G G G G G G G G G G G G G G G G G G G G G G G S G G G G G G G G G S S |
SSGGGGGGGGEEEGGGGSSEEEEEEEESSSEEEEGGSGGGGGGGGGGGGGGGGGGSS	S S G G G G G G G G E E E G G G G S S E E E E E E E E S S S E E E E G G S G G G G G G G G G G G G G G G G G G S S |
SSGGGGGGGGEEEGGGSGGGGGEEEEEESGGGGSSSGGGGGGEGGGGGGGGSSEEEEEGGGGSSGGGGGSS	S S G G G G G G G G E E E G G G S G G G G G E E E E E E S G G G G S S S G G G G G G E G G G G G G G G S S E E E E E G G G G S S G G G G G S S |
SSGGGGGGGGEEGGGGGGGGGGGGGGGGGGGS	S S G G G G G G G G E E G G G G G G G G G G G G G G G G G G G S |
SSGGGGGGGGEEGGGGGGSGGGGGGGGGGGGGGGGGGSGGGGGGGGS	S S G G G G G G G G E E G G G G G G S G G G G G G G G G G G G G G G G G G S G G G G G G G G S |
SSGGGGGGGGEEGGGGGGSS	S S G G G G G G G G E E G G G G G G S S |
SSGGGGGGGGEEGGGGSSSSGGGGSS	S S G G G G G G G G E E G G G G S S S S G G G G S S |
SSGGGGGGGGEEGGGSSGGGGGGGGGGGGGGGGGGS	S S G G G G G G G G E E G G G S S G G G G G G G G G G G G G G G G G G S |
SSGGGGGGGGEEGGS	S S G G G G G G G G E E G G S |
SSGGGGGGGGEEGGSGGGGGGGGGGGSEEEGGGGGGGGGGGSSSGGGGGGEEEGGSS	S S G G G G G G G G E E G G S G G G G G G G G G G G S E E E G G G G G G G G G G G S S S G G G G G G E E E G G S S |
SSGGGGGGGGEEGSSSSGGSSSGGGGGGGGGGGSSGGGGS	S S G G G G G G G G E E G S S S S G G S S S G G G G G G G G G G G S S G G G G S |
SSGGGGGGGGEEGSSSSSGGGGGGGGSGGGSSSGGGGGSSGGGGGGSSS	S S G G G G G G G G E E G S S S S S G G G G G G G G S G G G S S S G G G G G S S G G G G G G S S S |
SSGGGGGGGGEGEEEEEEEEEEEEEEEEGGEEGGGGGSS	S S G G G G G G G G E G E E E E E E E E E E E E E E E E G G E E G G G G G S S |
SSGGGGGGGGEGEGGGSSGGGGGGGGGGSS	S S G G G G G G G G E G E G G G S S G G G G G G G G G G S S |
SSGGGGGGGGEGGGGGGGGGGGGGGGGGGSS	S S G G G G G G G G E G G G G G G G G G G G G G G G G G G S S |
SSGGGGGGGGEGGGGGSSGGGGGGSGGGGGGGGGGGGGGGGSSGGGGGSS	S S G G G G G G G G E G G G G G S S G G G G G G S G G G G G G G G G G G G G G G G S S G G G G G S S |
SSGGGGGGGGEGGGSSS	S S G G G G G G G G E G G G S S S |
SSGGGGGGGGEGGSGGGGGGSS	S S G G G G G G G G E G G S G G G G G G S S |
SSGGGGGGGGEGGSS	S S G G G G G G G G E G G S S |
SSGGGGGGGGGEEEEEEGGEEEGGGGGGGGEEEGGGGGGGGGSS	S S G G G G G G G G G E E E E E E G G E E E G G G G G G G G E E E G G G G G G G G G S S |
SSGGGGGGGGGEEEEEEGGGGSS	S S G G G G G G G G G E E E E E E G G G G S S |
SSGGGGGGGGGEEEEEEGGGGSSS	S S G G G G G G G G G E E E E E E G G G G S S S |
SSGGGGGGGGGEEEGGGGGGGGS	S S G G G G G G G G G E E E G G G G G G G G S |
SSGGGGGGGGGEEEGGGGGGGGSSSSS	S S G G G G G G G G G E E E G G G G G G G G S S S S S |
SSGGGGGGGGGEEEGGGGGGGSGGGEEGGGGGSSSS	S S G G G G G G G G G E E E G G G G G G G S G G G E E G G G G G S S S S |
SSGGGGGGGGGEEEGGGGSSSEGGGSS	S S G G G G G G G G G E E E G G G G S S S E G G G S S |
SSGGGGGGGGGEEESSSSEGGGGGGGGGSGEEGGGSSSGGGGGGSS	S S G G G G G G G G G E E E S S S S E G G G G G G G G G S G E E G G G S S S G G G G G G S S |
SSGGGGGGGGGEEGEEEESEEGGSSSSGGGGGSS	S S G G G G G G G G G E E G E E E E S E E G G S S S S G G G G G S S |
SSGGGGGGGGGEEGGGEEEGGGGGGEEEEEGGGGGGS	S S G G G G G G G G G E E G G G E E E G G G G G G E E E E E G G G G G G S |
SSGGGGGGGGGEEGGGGGGGGSSSSSS	S S G G G G G G G G G E E G G G G G G G G S S S S S S |
SSGGGGGGGGGEEGGGGGGGS	S S G G G G G G G G G E E G G G G G G G S |
SSGGGGGGGGGEEGGGGGGGSS	S S G G G G G G G G G E E G G G G G G G S S |
SSGGGGGGGGGEEGGGGSS	S S G G G G G G G G G E E G G G G S S |
SSGGGGGGGGGEGGGEEEGGGGGGGGGGGSSGGSGGGGSS	S S G G G G G G G G G E G G G E E E G G G G G G G G G G G S S G G S G G G G S S |
SSGGGGGGGGGEGGGGGGEEGGGGS	S S G G G G G G G G G E G G G G G G E E G G G G S |
SSGGGGGGGGGEGGGGGGGGGGGGGGGGGGGGSS	S S G G G G G G G G G E G G G G G G G G G G G G G G G G G G G G S S |
SSGGGGGGGGGEGGGGGSS	S S G G G G G G G G G E G G G G G S S |
SSGGGGGGGGGEGGGSGGGGGGGGGGGGGGGGGGGSSGGGGGS	S S G G G G G G G G G E G G G S G G G G G G G G G G G G G G G G G G G S S G G G G G S |
SSGGGGGGGGGGEEEEGGGGGGGGGSS	S S G G G G G G G G G G E E E E G G G G G G G G G S S |
SSGGGGGGGGGGEEEEGGGGGGSGGGGGGGGSSSS	S S G G G G G G G G G G E E E E G G G G G G S G G G G G G G G S S S S |
SSGGGGGGGGGGEEEESGGGGSS	S S G G G G G G G G G G E E E E S G G G G S S |
SSGGGGGGGGGGEEEGGGGGGGGGGGGGSSGGGGGGGGGGGGGSS	S S G G G G G G G G G G E E E G G G G G G G G G G G G G S S G G G G G G G G G G G G G S S |
SSGGGGGGGGGGEEEGGGGGGGGSSSGGGGGGGGS	S S G G G G G G G G G G E E E G G G G G G G G S S S G G G G G G G G S |
SSGGGGGGGGGGEEEGGGGGS	S S G G G G G G G G G G E E E G G G G G S |
SSGGGGGGGGGGEEEGGGGGSS	S S G G G G G G G G G G E E E G G G G G S S |
SSGGGGGGGGGGEEGGEEGGGGGGSS	S S G G G G G G G G G G E E G G E E G G G G G G S S |
SSGGGGGGGGGGEEGGGGGGGGGGGGGGGGS	S S G G G G G G G G G G E E G G G G G G G G G G G G G G G G S |
SSGGGGGGGGGGEEGGGGGGGGGGSSGGGGGGSGGGGGSSS	S S G G G G G G G G G G E E G G G G G G G G G G S S G G G G G G S G G G G G S S S |
SSGGGGGGGGGGEEGGGGGGGGGSSS	S S G G G G G G G G G G E E G G G G G G G G G S S S |
SSGGGGGGGGGGEEGGGGGGGGSSSSGGGGGGGGSS	S S G G G G G G G G G G E E G G G G G G G G S S S S G G G G G G G G S S |
SSGGGGGGGGGGEEGGGGGGGS	S S G G G G G G G G G G E E G G G G G G G S |
SSGGGGGGGGGGEGGGGEEGGGGGGSS	S S G G G G G G G G G G E G G G G E E G G G G G G S S |
SSGGGGGGGGGGEGGGGGGGGGGGGSS	S S G G G G G G G G G G E G G G G G G G G G G G G S S |
SSGGGGGGGGGGGEEEEGGGGGGGGGGEGGGGGGGSS	S S G G G G G G G G G G G E E E E G G G G G G G G G G E G G G G G G G S S |
SSGGGGGGGGGGGEEEESGGGGGGGGGGSSS	S S G G G G G G G G G G G E E E E S G G G G G G G G G G S S S |
SSGGGGGGGGGGGEEEGGGEEEESS	S S G G G G G G G G G G G E E E G G G E E E E S S |
SSGGGGGGGGGGGEEEGGGGGGGGGS	S S G G G G G G G G G G G E E E G G G G G G G G G S |
SSGGGGGGGGGGGEEEGGGGGGGGSGGGGGSSGGEEGGGGGGSS	S S G G G G G G G G G G G E E E G G G G G G G G S G G G G G S S G G E E G G G G G G S S |
SSGGGGGGGGGGGEEGGEEGGGGGGGS	S S G G G G G G G G G G G E E G G E E G G G G G G G S |
SSGGGGGGGGGGGEEGGGGGGGS	S S G G G G G G G G G G G E E G G G G G G G S |
SSGGGGGGGGGGGEEGGGGGGGSS	S S G G G G G G G G G G G E E G G G G G G G S S |
SSGGGGGGGGGGGEEGGGGGSS	S S G G G G G G G G G G G E E G G G G G S S |
SSGGGGGGGGGGGEEGSSSGGGGGGGGGGGGGGSS	S S G G G G G G G G G G G E E G S S S G G G G G G G G G G G G G G S S |
SSGGGGGGGGGGGEESSSSSSSSGGGGGGGGGSS	S S G G G G G G G G G G G E E S S S S S S S S G G G G G G G G G S S |
SSGGGGGGGGGGGEGEEGGGGGSS	S S G G G G G G G G G G G E G E E G G G G G S S |
SSGGGGGGGGGGGEGGGGEEEGGGGGGSS	S S G G G G G G G G G G G E G G G G E E E G G G G G G S S |
SSGGGGGGGGGGGEGGGGSGGGGGGGGGGS	S S G G G G G G G G G G G E G G G G S G G G G G G G G G G S |
SSGGGGGGGGGGGEGGGSGGEGGGGSS	S S G G G G G G G G G G G E G G G S G G E G G G G S S |
SSGGGGGGGGGGGGEEEEEEEGEEESGGGGGS	S S G G G G G G G G G G G G E E E E E E E G E E E S G G G G G S |
SSGGGGGGGGGGGGEEESGGGGGGGGGGGGGGSSSSS	S S G G G G G G G G G G G G E E E S G G G G G G G G G G G G G G S S S S S |
SSGGGGGGGGGGGGEEESSSEEGGGSSGEEEEEGGGGGGS	S S G G G G G G G G G G G G E E E S S S E E G G G S S G E E E E E G G G G G G S |
SSGGGGGGGGGGGGEEGGGGGGSS	S S G G G G G G G G G G G G E E G G G G G G S S |
SSGGGGGGGGGGGGEEGGGSSS	S S G G G G G G G G G G G G E E G G G S S S |
SSGGGGGGGGGGGGEGEGGGGGGGGGGGGS	S S G G G G G G G G G G G G E G E G G G G G G G G G G G G S |
SSGGGGGGGGGGGGEGGGGGGGGGGSS	S S G G G G G G G G G G G G E G G G G G G G G G G S S |
SSGGGGGGGGGGGGEGGGGGS	S S G G G G G G G G G G G G E G G G G G S |
SSGGGGGGGGGGGGGEEEGGGGEEEGEEESSSSGGGGGGGGGGGEEGGGGSS	S S G G G G G G G G G G G G G E E E G G G G E E E G E E E S S S S G G G G G G G G G G G E E G G G G S S |
SSGGGGGGGGGGGGGEEEGGGGGGGGGSS	S S G G G G G G G G G G G G G E E E G G G G G G G G G S S |
SSGGGGGGGGGGGGGEEES	S S G G G G G G G G G G G G G E E E S |
SSGGGGGGGGGGGGGEEGGGGGSGGGGGGGGGGGGGGGS	S S G G G G G G G G G G G G G E E G G G G G S G G G G G G G G G G G G G G G S |
SSGGGGGGGGGGGGGEEGGGGGSS	S S G G G G G G G G G G G G G E E G G G G G S S |
SSGGGGGGGGGGGGGEEGGGSS	S S G G G G G G G G G G G G G E E G G G S S |
SSGGGGGGGGGGGGGEGGGGGGGGGGGSS	S S G G G G G G G G G G G G G E G G G G G G G G G G G S S |
SSGGGGGGGGGGGGGEGGGGGGGSGGSS	S S G G G G G G G G G G G G G E G G G G G G G S G G S S |
SSGGGGGGGGGGGGGEGGGGS	S S G G G G G G G G G G G G G E G G G G S |
SSGGGGGGGGGGGGGGEEEGGGGGGEESSEEGGGSSSS	S S G G G G G G G G G G G G G G E E E G G G G G G E E S S E E G G G S S S S |
SSGGGGGGGGGGGGGGEEEGGGGGSEEEGGGGS	S S G G G G G G G G G G G G G G E E E G G G G G S E E E G G G G S |
SSGGGGGGGGGGGGGGEEGGGGGGGGGGSS	S S G G G G G G G G G G G G G G E E G G G G G G G G G G S S |
SSGGGGGGGGGGGGGGEEGGGGGGGSSS	S S G G G G G G G G G G G G G G E E G G G G G G G S S S |
SSGGGGGGGGGGGGGGEGGGGGGGGGGGGGGGGGGGSSSS	S S G G G G G G G G G G G G G G E G G G G G G G G G G G G G G G G G G G S S S S |
SSGGGGGGGGGGGGGGEGGGGGGSS	S S G G G G G G G G G G G G G G E G G G G G G S S |
SSGGGGGGGGGGGGGGGEEEEGGGGGGGGSGGGGGGGGGGGGGGS	S S G G G G G G G G G G G G G G G E E E E G G G G G G G G S G G G G G G G G G G G G G G S |
SSGGGGGGGGGGGGGGGEEEGGGEEGGGGEEGGGGS	S S G G G G G G G G G G G G G G G E E E G G G E E G G G G E E G G G G S |
SSGGGGGGGGGGGGGGGEEEGGGGGGGS	S S G G G G G G G G G G G G G G G E E E G G G G G G G S |
SSGGGGGGGGGGGGGGGEGEEGGGGGS	S S G G G G G G G G G G G G G G G E G E E G G G G G S |
SSGGGGGGGGGGGGGGGEGGGGGSS	S S G G G G G G G G G G G G G G G E G G G G G S S |
SSGGGGGGGGGGGGGGGEGGGSEEGGGGGEEEGGEEGGGGSS	S S G G G G G G G G G G G G G G G E G G G S E E G G G G G E E E G G E E G G G G S S |
SSGGGGGGGGGGGGGGGGEEEGGG	S S G G G G G G G G G G G G G G G G E E E G G G |
SSGGGGGGGGGGGGGGGGEEEGGGGGGGGGGGGGGGS	S S G G G G G G G G G G G G G G G G E E E G G G G G G G G G G G G G G G S |
SSGGGGGGGGGGGGGGGGEEEGGGSSSGGGGGGGGGGGGGGGSSSSGGGGGSSS	S S G G G G G G G G G G G G G G G G E E E G G G S S S G G G G G G G G G G G G G G G S S S S G G G G G S S S |
SSGGGGGGGGGGGGGGGGEEES	S S G G G G G G G G G G G G G G G G E E E S |
SSGGGGGGGGGGGGGGGGEEGGGGGGGGGGGGGGGGSSSGGGGGGGGGSS	S S G G G G G G G G G G G G G G G G E E G G G G G G G G G G G G G G G G S S S G G G G G G G G G S S |
SSGGGGGGGGGGGGGGGGGEEEEGGGGGGGGGGGSS	S S G G G G G G G G G G G G G G G G G E E E E G G G G G G G G G G G S S |
SSGGGGGGGGGGGGGGGGGEGGGGGGGSS	S S G G G G G G G G G G G G G G G G G E G G G G G G G S S |
SSGGGGGGGGGGGGGGGGGGEEGGGGGGGGS	S S G G G G G G G G G G G G G G G G G G E E G G G G G G G G S |
SSGGGGGGGGGGGGGGGGGGEGEEGGGGGGGGSS	S S G G G G G G G G G G G G G G G G G G E G E E G G G G G G G G S S |
SSGGGGGGGGGGGGGGGGGGEGGGGGGGGGGGGGGGGGGS	S S G G G G G G G G G G G G G G G G G G E G G G G G G G G G G G G G G G G G G S |
SSGGGGGGGGGGGGGGGGGGGEEEEGGGGS	S S G G G G G G G G G G G G G G G G G G G E E E E G G G G S |
SSGGGGGGGGGGGGGGGGGGGGEEEGGGGGGGGGSSS	S S G G G G G G G G G G G G G G G G G G G G E E E G G G G G G G G G S S S |
SSGGGGGGGGGGGGGGGGGGGGEEEGGGGGGS	S S G G G G G G G G G G G G G G G G G G G G E E E G G G G G G S |
SSGGGGGGGGGGGGGGGGGGGGEGGGGGGS	S S G G G G G G G G G G G G G G G G G G G G E G G G G G G S |
SSGGGGGGGGGGGGGGGGGGGGGEEEGGGSSGGGGGGSS	S S G G G G G G G G G G G G G G G G G G G G G E E E G G G S S G G G G G G S S |
SSGGGGGGGGGGGGGGGGGGGGGEEGEEEGGGGGGGS	S S G G G G G G G G G G G G G G G G G G G G G E E G E E E G G G G G G G S |
SSGGGGGGGGGGGGGGGGGGGGGEEGGGGGGSS	S S G G G G G G G G G G G G G G G G G G G G G E E G G G G G G S S |
SSGGGGGGGGGGGGGGGGGGGGGGEEEGGGGGGGGGGGSS	S S G G G G G G G G G G G G G G G G G G G G G G E E E G G G G G G G G G G G S S |
SSGGGGGGGGGGGGGGGGGGGGGGEEEGGGGGGGGGSS	S S G G G G G G G G G G G G G G G G G G G G G G E E E G G G G G G G G G S S |
SSGGGGGGGGGGGGGGGGGGGGGGGEEEGGGGGGGSS	S S G G G G G G G G G G G G G G G G G G G G G G G E E E G G G G G G G S S |
SSGGGGGGGGGGGGGGGGGGGGGGGGEEGGGGGGGGGGGGEEGGGGGGGGGGGGGGSS	S S G G G G G G G G G G G G G G G G G G G G G G G G E E G G G G G G G G G G G G E E G G G G G G G G G G G G G G S S |
SSGGGGGGGGGGGGGGGGGGGGGGGGEEGGGGGGGSSS	S S G G G G G G G G G G G G G G G G G G G G G G G G E E G G G G G G G S S S |
SSGGGGGGGGGGGGGGGGGGGGGGGGGEG	S S G G G G G G G G G G G G G G G G G G G G G G G G G E G |
SSGGGGGGGGGGGGGGGGGGGGGGGGGGGGGGESGGGGGGGGS	S S G G G G G G G G G G G G G G G G G G G G G G G G G G G G G G E S G G G G G G G G S |
SSGGGGGGGGGGGGGGGGGGGGGGGGGGGGGGGGSSSSSSSSSSGGGEEEGGGGGGGGSS	S S G G G G G G G G G G G G G G G G G G G G G G G G G G G G G G G G S S S S S S S S S S G G G E E E G G G G G G G G S S |
SSGGGGGGGGGGGGGGGGGGGGGGGGGGGGGSGGGGGGGGGEEGGGGGSS	S S G G G G G G G G G G G G G G G G G G G G G G G G G G G G G S G G G G G G G G G E E G G G G G S S |
SSGGGGGGGGGGGGGGGGGGGGGGGGGGGGSEEEGGGSS	S S G G G G G G G G G G G G G G G G G G G G G G G G G G G G S E E E G G G S S |
SSGGGGGGGGGGGGGGGGGGGGGGGGGGGSEEGGGGGGGGGGGSS	S S G G G G G G G G G G G G G G G G G G G G G G G G G G G S E E G G G G G G G G G G G S S |
SSGGGGGGGGGGGGGGGGGGGGGSEEEEGGGGGGGGGGSGGGGGGSS	S S G G G G G G G G G G G G G G G G G G G G G S E E E E G G G G G G G G G G S G G G G G G S S |
SSGGGGGGGGGGGGGGGGGGGGSEEGGGGGGGGGGGGGGGGGGGGGS	S S G G G G G G G G G G G G G G G G G G G G S E E G G G G G G G G G G G G G G G G G G G G G S |
SSGGGGGGGGGGGGGGGGGGSEEGGGGGEESEEEGGSGGSGGGGGGGGGGS	S S G G G G G G G G G G G G G G G G G G S E E G G G G G E E S E E E G G S G G S G G G G G G G G G G S |
SSGGGGGGGGGGGGGGGGGSGGGGEEEEGGGGGGGGSG	S S G G G G G G G G G G G G G G G G G S G G G G E E E E G G G G G G G G S G |
SSGGGGGGGGGGGGGGGGGSSGGGGGEEEEEEGGGGGGS	S S G G G G G G G G G G G G G G G G G S S G G G G G E E E E E E G G G G G G S |
SSGGGGGGGGGGGGGGGGSGGGGGGGGGEEEGGGGGGGGGGSS	S S G G G G G G G G G G G G G G G G S G G G G G G G G G E E E G G G G G G G G G G S S |
SSGGGGGGGGGGGGGGGGSGGGGGGGGGGGGGGSSGGEEEGGGGGGGEEEGGGGGGSS	S S G G G G G G G G G G G G G G G G S G G G G G G G G G G G G G G S S G G E E E G G G G G G G E E E G G G G G G S S |
SSGGGGGGGGGGGGGGGGSGGGGGGGGGGGSSSSSEEEEEGGGGGSS	S S G G G G G G G G G G G G G G G G S G G G G G G G G G G G S S S S S E E E E E G G G G G S S |
SSGGGGGGGGGGGGGGGGSSSSGGGGGGGGEEGGSSSGGGS	S S G G G G G G G G G G G G G G G G S S S S G G G G G G G G E E G G S S S G G G S |
SSGGGGGGGGGGGGGGGSGGEEEGGGGGGGGGGGGGGSS	S S G G G G G G G G G G G G G G G S G G E E E G G G G G G G G G G G G G G S S |
SSGGGGGGGGGGGGGGGSGGGGGGGGGGEEEEEEESSSSSSSGGGGGGGGGGGSS	S S G G G G G G G G G G G G G G G S G G G G G G G G G G E E E E E E E S S S S S S S G G G G G G G G G G G S S |
SSGGGGGGGGGGGGGGSEEEGGGGSS	S S G G G G G G G G G G G G G G S E E E G G G G S S |
SSGGGGGGGGGGGGGGSGGEGGGGGSS	S S G G G G G G G G G G G G G G S G G E G G G G G S S |
SSGGGGGGGGGGGGGGSGGGGGGSSSSEEEEGGGGGGGSS	S S G G G G G G G G G G G G G G S G G G G G G S S S S E E E E G G G G G G G S S |
SSGGGGGGGGGGGGGGSSGGGEEGGGGGGGGGGS	S S G G G G G G G G G G G G G G S S G G G E E G G G G G G G G G G S |
SSGGGGGGGGGGGGGGSSGGGGGGEEEGGGGGGGGGGGGSSGGGGGGGGGGGGGGGGGGGGGGGGGSS	S S G G G G G G G G G G G G G G S S G G G G G G E E E G G G G G G G G G G G G S S G G G G G G G G G G G G G G G G G G G G G G G G G S S |
SSGGGGGGGGGGGGGGSSGGGGGGGGGGGGSSSSEEEEGGGGGSSSSGGGGGGGGSSGGSS	S S G G G G G G G G G G G G G G S S G G G G G G G G G G G G S S S S E E E E G G G G G S S S S G G G G G G G G S S G G S S |
SSGGGGGGGGGGGGGGSSGGGGGGGGGSSGGGSSEEEEGGGGGSS	S S G G G G G G G G G G G G G G S S G G G G G G G G G S S G G G S S E E E E G G G G G S S |
SSGGGGGGGGGGGGGGSSSSSSSSGGGGGSGGGGGGGGSSGGGGGSSSEEEEEESGGGGGGGGGGGGGGGGGGGGGGS	S S G G G G G G G G G G G G G G S S S S S S S S G G G G G S G G G G G G G G S S G G G G G S S S E E E E E E S G G G G G G G G G G G G G G G G G G G G G G S |
SSGGGGGGGGGGGGGSGGGGGGGGGEEGGGSS	S S G G G G G G G G G G G G G S G G G G G G G G G E E G G G S S |
SSGGGGGGGGGGGGGSGGGGGGGGGGGGSGGGGGEEEEGGGGGGSSSGGGGSS	S S G G G G G G G G G G G G G S G G G G G G G G G G G G S G G G G G E E E E G G G G G G S S S G G G G S S |
SSGGGGGGGGGGGGGSSGGEEGGGGSGGGGGGGGGGSS	S S G G G G G G G G G G G G G S S G G E E G G G G S G G G G G G G G G G S S |
SSGGGGGGGGGGGGGSSGGGGGGGGGGGGGEEEGGGGGSS	S S G G G G G G G G G G G G G S S G G G G G G G G G G G G G E E E G G G G G S S |
SSGGGGGGGGGGGGGSSSEEGGGGGSGSGGGGGG	S S G G G G G G G G G G G G G S S S E E G G G G G S G S G G G G G G |
SSGGGGGGGGGGGGSEEEEGGGSS	S S G G G G G G G G G G G G S E E E E G G G S S |
SSGGGGGGGGGGGGSEGGGGGGSS	S S G G G G G G G G G G G G S E G G G G G G S S |
SSGGGGGGGGGGGGSGGGEEEGGGGGEEEGGGGGGGGGGGGGSS	S S G G G G G G G G G G G G S G G G E E E G G G G G E E E G G G G G G G G G G G G G S S |
SSGGGGGGGGGGGGSGGGGEEESSS	S S G G G G G G G G G G G G S G G G G E E E S S S |
SSGGGGGGGGGGGGSGGGGGGEGGGGGGGGGGGGGSS	S S G G G G G G G G G G G G S G G G G G G E G G G G G G G G G G G G G S S |
SSGGGGGGGGGGGGSGGGGGSEEEEEEGSGGGGGGGGGGGGS	S S G G G G G G G G G G G G S G G G G G S E E E E E E G S G G G G G G G G G G G G S |
SSGGGGGGGGGGGSEEEEGGGGGGGGGGGGGGGGGGGGGGGSS	S S G G G G G G G G G G G S E E E E G G G G G G G G G G G G G G G G G G G G G G G S S |
SSGGGGGGGGGGGSEEEGGGGGGGGGGGSS	S S G G G G G G G G G G G S E E E G G G G G G G G G G G S S |
SSGGGGGGGGGGGSEEGGGGSS	S S G G G G G G G G G G G S E E G G G G S S |
SSGGGGGGGGGGGSGGGGGGGGGGGEEEEGGGSS	S S G G G G G G G G G G G S G G G G G G G G G G G E E E E G G G S S |
SSGGGGGGGGGGGSGGGSGGGGGSSSGGGGSSSSSGGGEEGSGGGGGGGGGSSS	S S G G G G G G G G G G G S G G G S G G G G G S S S G G G G S S S S S G G G E E G S G G G G G G G G G S S S |
SSGGGGGGGGGGGSSGGGGGGGGGGSSGGEEGGGGGGSSSS	S S G G G G G G G G G G G S S G G G G G G G G G G S S G G E E G G G G G G S S S S |
SSGGGGGGGGGGGSSGGGGSSSSGGGGGGGGGGGGSSGGGGGGGSSEEEEEEGGGGSS	S S G G G G G G G G G G G S S G G G G S S S S G G G G G G G G G G G G S S G G G G G G G S S E E E E E E G G G G S S |
SSGGGGGGGGGGGSSGGSSSSGGGGGGEEEEGGGGSS	S S G G G G G G G G G G G S S G G S S S S G G G G G G E E E E G G G G S S |
SSGGGGGGGGGGSEEEEEEGGGSSSSSSGGGGGGGGGGGGGGGSS	S S G G G G G G G G G G S E E E E E E G G G S S S S S S G G G G G G G G G G G G G G G S S |
SSGGGGGGGGGGSEEEEGGGEEGGGGGGS	S S G G G G G G G G G G S E E E E G G G E E G G G G G G S |
SSGGGGGGGGGGSEEEEGSS	S S G G G G G G G G G G S E E E E G S S |
SSGGGGGGGGGGSGGGGGGGEGGGGSS	S S G G G G G G G G G G S G G G G G G G E G G G G S S |
SSGGGGGGGGGGSGGGGGGGGGEEEGGGGGGGGSS	S S G G G G G G G G G G S G G G G G G G G G E E E G G G G G G G G S S |
SSGGGGGGGGGGSGGGGGGGGGGGGGGGGGSEEEGGGGGGGGSS	S S G G G G G G G G G G S G G G G G G G G G G G G G G G G G S E E E G G G G G G G G S S |
SSGGGGGGGGGGSGGGGGSSSSGGGGGGGGGEEGGGGGGGGSSGGGGGGGGGSGGGGGGGGGSS	S S G G G G G G G G G G S G G G G G S S S S G G G G G G G G G E E G G G G G G G G S S G G G G G G G G G S G G G G G G G G G S S |
SSGGGGGGGGGGSSGGGGGGGGGGGGGGGSGGGGGGGGSSGGGGGGGGGSGGGEEEEGGGGGGGGS	S S G G G G G G G G G G S S G G G G G G G G G G G G G G G S G G G G G G G G S S G G G G G G G G G S G G G E E E E G G G G G G G G S |
SSGGGGGGGGGGSSSEEEEEEEEEGGGGSGGGGGGGGGSGGGGGGGGGGGSSSS	S S G G G G G G G G G G S S S E E E E E E E E E G G G G S G G G G G G G G G S G G G G G G G G G G G S S S S |
SSGGGGGGGGGGSSSGGGGGGGGGGGSGGGGGGGSSGGGGGGSSSSEEESSSSEEEGGGGSSSS	S S G G G G G G G G G G S S S G G G G G G G G G G G S G G G G G G G S S G G G G G G S S S S E E E S S S S E E E G G G G S S S S |
SSGGGGGGGGGGSSSSGGGEEEEGGGGGGSSGGGGSSS	S S G G G G G G G G G G S S S S G G G E E E E G G G G G G S S G G G G S S S |
SSGGGGGGGGGGSSSSSEGGGGGGGGGGGS	S S G G G G G G G G G G S S S S S E G G G G G G G G G G G S |
SSGGGGGGGGGSEEEGGGGGGGSGGGGGGGGGGGGGGS	S S G G G G G G G G G S E E E G G G G G G G S G G G G G G G G G G G G G G S |
SSGGGGGGGGGSEGSSGGGGGGGGGGSS	S S G G G G G G G G G S E G S S G G G G G G G G G G S S |
SSGGGGGGGGGSSGGEEGGGGGGSSGGGGGGGGGGGGGGGGSS	S S G G G G G G G G G S S G G E E G G G G G G S S G G G G G G G G G G G G G G G G S S |
SSGGGGGGGGGSSGGGEEGGGGGGGGEGGGGGGSS	S S G G G G G G G G G S S G G G E E G G G G G G G G E G G G G G G S S |
SSGGGGGGGGGSSGGGGGGGGEEGGSS	S S G G G G G G G G G S S G G G G G G G G E E G G S S |
SSGGGGGGGGGSSGGGGGGGGSEEEGGSSSSSGGGGGGGGGGGGGGGGGGGGSS	S S G G G G G G G G G S S G G G G G G G G S E E E G G S S S S S G G G G G G G G G G G G G G G G G G G G S S |
SSGGGGGGGGGSSSGGGGGGGGGGGGGGSSEEEGGGGGGGGGGGGGGGGSGGGGGGGSGGGGSGGGGGGGSSSGGGGS	S S G G G G G G G G G S S S G G G G G G G G G G G G G G S S E E E G G G G G G G G G G G G G G G G S G G G G G G G S G G G G S G G G G G G G S S S G G G G S |
SSGGGGGGGGGSSSSGGGGGSEEGGGGGGGSS	S S G G G G G G G G G S S S S G G G G G S E E G G G G G G G S S |
SSGGGGGGGGSGGGEEGGGGGGGGGGSS	S S G G G G G G G G S G G G E E G G G G G G G G G G S S |
SSGGGGGGGGSGGGGGGGGGGGGGGGGGGGSSSSSEEE	S S G G G G G G G G S G G G G G G G G G G G G G G G G G G G S S S S S E E E |
SSGGGGGGGGSGGGGSSEESSSGGGGGGGGGSGGGGGGGGGGGGGSS	S S G G G G G G G G S G G G G S S E E S S S G G G G G G G G G S G G G G G G G G G G G G G S S |
SSGGGGGGGGSSGGGSSSSSSGGSSSSGGGGGGSSEEEGGGGEEEEEEGGGEGGGGGGSS	S S G G G G G G G G S S G G G S S S S S S G G S S S S G G G G G G S S E E E G G G G E E E E E E G G G E G G G G G G S S |
SSGGGGGGGGSSSSSGGGGGGSEEEEEGGGGGGSGGGGSSSS	S S G G G G G G G G S S S S S G G G G G G S E E E E E G G G G G G S G G G G S S S S |
SSGGGGGGGGSSSSSSEEEGGGGGGGSS	S S G G G G G G G G S S S S S S E E E G G G G G G G S S |
SSGGGGGGGSEEGGGSGGGGGGGGGGGGS	S S G G G G G G G S E E G G G S G G G G G G G G G G G G S |
SSGGGGGGGSGEEEGGGGGGGGGGGGGGGGSS	S S G G G G G G G S G E E E G G G G G G G G G G G G G G G G S S |
SSGGGGGGGSGGEEGGGGGEEGGGGGGGSS	S S G G G G G G G S G G E E G G G G G E E G G G G G G G S S |
SSGGGGGGGSGGGGGEEGGGGGGGGGGGGGGEEGGGGGGGGGGGGSS	S S G G G G G G G S G G G G G E E G G G G G G G G G G G G G G E E G G G G G G G G G G G G S S |
SSGGGGGGGSGGGGGEEGGGSSS	S S G G G G G G G S G G G G G E E G G G S S S |
SSGGGGGGGSGGGGGGEEGSGGGGGGGGGGSS	S S G G G G G G G S G G G G G G E E G S G G G G G G G G G G S S |
SSGGGGGGGSGGGGGGGGGGGEEGGGSSGGGGS	S S G G G G G G G S G G G G G G G G G G G E E G G G S S G G G G S |
SSGGGGGGGSGGGGGGGGGGGGGEGGGGGSSS	S S G G G G G G G S G G G G G G G G G G G G G E G G G G G S S S |
SSGGGGGGGSSEEEEEEGGEEEGGGGSS	S S G G G G G G G S S E E E E E E G G E E E G G G G S S |
SSGGGGGGGSSSGGGGEEGGGGGSSSGGGGGEEEEEEEESSGGGGSSSGGGGGGGS	S S G G G G G G G S S S G G G G E E G G G G G S S S G G G G G E E E E E E E E S S G G G G S S S G G G G G G G S |
SSGGGGGGGSSSSSGGGGGGGSSGGGGSGGGGGSGGGGGGGGGSGGGEEGGGGGGGGS	S S G G G G G G G S S S S S G G G G G G G S S G G G G S G G G G G S G G G G G G G G G S G G G E E G G G G G G G G S |
SSGGGGGGGSSSSSSGGGGGEEEESSSSSSSSSSGGGSSGGGGGGGGSGGGGEESGGGGSSGGGSGGGSSSGGGGGGGGGGGGGGGGGGGSS	S S G G G G G G G S S S S S S G G G G G E E E E S S S S S S S S S S G G G S S G G G G G G G G S G G G G E E S G G G G S S G G G S G G G S S S G G G G G G G G G G G G G G G G G G G S S |
SSGGGGGGGSSSSSSSGGGGGGGGGGEEEEESSSSSSSSGGGGGGGGGSS	S S G G G G G G G S S S S S S S G G G G G G G G G G E E E E E S S S S S S S S G G G G G G G G G S S |
SSGGGGGGSEEEEGGGGGGEEEEEGGGGSS	S S G G G G G G S E E E E G G G G G G E E E E E G G G G S S |
SSGGGGGGSGGGEEGGGSSSSGGGGGGGGGGSGGGGGGSS	S S G G G G G G S G G G E E G G G S S S S G G G G G G G G G G S G G G G G G S S |
SSGGGGGGSGGGGEEGGGGGGS	S S G G G G G G S G G G G E E G G G G G G S |
SSGGGGGGSGGGGGGEEEEGGGGGGGGGGSS	S S G G G G G G S G G G G G G E E E E G G G G G G G G G G S S |
SSGGGGGGSGGGGGGEGGGGGGEEGGGGGGGGS	S S G G G G G G S G G G G G G E G G G G G G E E G G G G G G G G S |
SSGGGGGGSGGGGGGESSSEEEEEEEGSGGGGGGGSS	S S G G G G G G S G G G G G G E S S S E E E E E E E G S G G G G G G G S S |
SSGGGGGGSGGGGGGGGGEEGGGGGSS	S S G G G G G G S G G G G G G G G G E E G G G G G S S |
SSGGGGGGSSEEESSEEGGEEEGSSSSSSSSGGGGGGGGS	S S G G G G G G S S E E E S S E E G G E E E G S S S S S S S S G G G G G G G G S |
SSGGGGGGSSGGGGEEGGGGGGGGGGGGGGGGGGGGSSGGGGGGGGGGGGSS	S S G G G G G G S S G G G G E E G G G G G G G G G G G G G G G G G G G G S S G G G G G G G G G G G G S S |
SSGGGGGGSSGGGGGGGEGGGGGGGGGGGGGGGGGGGEEGGGGGSGGGSS	S S G G G G G G S S G G G G G G G E G G G G G G G G G G G G G G G G G G G E E G G G G G S G G G S S |
SSGGGGGGSSGGGGGGGGGGGGGGGEGGGGGS	S S G G G G G G S S G G G G G G G G G G G G G G G E G G G G G S |
SSGGGGGGSSGGGGGSEEGGGSSGGGGGGGGGGGGGGGGGGGGGGGGGGGGGGGGGGGGSS	S S G G G G G G S S G G G G G S E E G G G S S G G G G G G G G G G G G G G G G G G G G G G G G G G G G G G G G G G G G S S |
SSGGGGGSEEEEGGGGGGGGGGGGEEEGGGGGGGGGSS	S S G G G G G S E E E E G G G G G G G G G G G G E E E G G G G G G G G G S S |
SSGGGGGSEEEGGGGSGEEGGGS	S S G G G G G S E E E G G G G S G E E G G G S |
SSGGGGGSEEGGGGGGGGGGGGGGGGGGGGGGGGGGGGGGGGGGS	S S G G G G G S E E G G G G G G G G G G G G G G G G G G G G G G G G G G G G G G G G G G S |
SSGGGGGSGGGGEEEEGGGGGGGSSS	S S G G G G G S G G G G E E E E G G G G G G G S S S |
SSGGGGGSGGGGGGGEEEEGGGGGGGGGGGGGGGGGGGSGGGGGGGS	S S G G G G G S G G G G G G G E E E E G G G G G G G G G G G G G G G G G G G S G G G G G G G S |
SSGGGGGSGGGGGGSEEEEEGGEEGGGGGGGGSS	S S G G G G G S G G G G G G S E E E E E G G E E G G G G G G G G S S |
SSGGGGGSGGSSEESGGGGGGSS	S S G G G G G S G G S S E E S G G G G G G S S |
SSGGGGGSSEEEEGGGGGGSSGGGGGGGGGGSS	S S G G G G G S S E E E E G G G G G G S S G G G G G G G G G G S S |
SSGGGGGSSGGGGSSSSGGEEGSSSSGGGGGGGGGGGGGSS	S S G G G G G S S G G G G S S S S G G E E G S S S S G G G G G G G G G G G G G S S |
SSGGGGGSSSGGGGGGSEEEEGGGGGGGGGGGGEEGGGGGGS	S S G G G G G S S S G G G G G G S E E E E G G G G G G G G G G G G E E G G G G G G S |
SSGGGGSEEEGGEEEEGGEGEEGEESSEEEESSSSSSSSSSGGGGGGGS	S S G G G G S E E E G G E E E E G G E G E E G E E S S E E E E S S S S S S S S S S G G G G G G G S |
SSGGGGSEEGGGGGGGGGGGGGSS	S S G G G G S E E G G G G G G G G G G G G G S S |
SSGGGGSEEGGGGGGGGSSSS	S S G G G G S E E G G G G G G G G S S S S |
SSGGGGSESESSSSSEESSSSSGGGGGGGGGGGGGGGGGGGGGSSGGGGGGGGSS	S S G G G G S E S E S S S S S E E S S S S S G G G G G G G G G G G G G G G G G G G G G S S G G G G G G G G S S |
SSGGGGSGGGGGGEEGGSS	S S G G G G S G G G G G G E E G G S S |
SSGGGGSGGGGGGGEEGGGGGGGGGGSGGGGGGGGGS	S S G G G G S G G G G G G G E E G G G G G G G G G G S G G G G G G G G G S |
SSGGGGSGGGGGGGGGGGGGEEGGGGGSS	S S G G G G S G G G G G G G G G G G G G E E G G G G G S S |
SSGGGGSGGGGGSSEESSSSGGGGSEEGGGGSSGGGGGGS	S S G G G G S G G G G G S S E E S S S S G G G G S E E G G G G S S G G G G G G S |
SSGGGGSSEEESSSSSEEGGEEEEEEGGGGGGGGGGGGSS	S S G G G G S S E E E S S S S S E E G G E E E E E E G G G G G G G G G G G G S S |
SSGGGGSSGGGEEESGGGGGGGGGGGSS	S S G G G G S S G G G E E E S G G G G G G G G G G G S S |
SSGGGGSSGGGGGGGGGGSSGGGGGGGGGGGGEEEESGGGGGGGGGGGGGSGGGGGSSG	S S G G G G S S G G G G G G G G G G S S G G G G G G G G G G G G E E E E S G G G G G G G G G G G G G S G G G G G S S G |
SSGGGGSSGGSGGGGGGEEEGGGGGGGGGSSGGGGGSGGGGGGSS	S S G G G G S S G G S G G G G G G E E E G G G G G G G G G S S G G G G G S G G G G G G S S |
SSGGGGSSSSGGGGGGGGGGGGGGGGGGGSSSGGGGGGGSGGGGGGGGSSSGGGGGGGGGEEGGGGGSS	S S G G G G S S S S G G G G G G G G G G G G G G G G G G G S S S G G G G G G G S G G G G G G G G S S S G G G G G G G G G E E G G G G G S S |
SSGGGGSSSSSEEEGGGGGEGGGSEEEGGSSSGGGSSSGGGGGGGGGGGSSGGGGGGGSS	S S G G G G S S S S S E E E G G G G G E G G G S E E E G G S S S G G G S S S G G G G G G G G G G G S S G G G G G G G S S |
SSGGGGSSSSSGGGEEEGGGGGGGGGGGGGGSS	S S G G G G S S S S S G G G E E E G G G G G G G G G G G G G G S S |
SSGGGSGGGGGGGEEEEGGGGGEEEGGGGGGGSS	S S G G G S G G G G G G G E E E E G G G G G E E E G G G G G G G S S |
SSGGGSGGGGGGGSGGGGGEGGSS	S S G G G S G G G G G G G S G G G G G E G G S S |
SSGGGSSGGGGEEEEESSGGGGGGGGSSSGGGGGGGGGSS	S S G G G S S G G G G E E E E E S S G G G G G G G G S S S G G G G G G G G G S S |
SSGGGSSGGGGGGGGGSEEEGGGGGGGGGGSGGGGGGGGGGGGGGSSS	S S G G G S S G G G G G G G G G S E E E G G G G G G G G G G S G G G G G G G G G G G G G G S S S |
SSGGGSSGGGGGGGGSSSEEEGGGGSGGGSSSGGGGGGGS	S S G G G S S G G G G G G G G S S S E E E G G G G S G G G S S S G G G G G G G S |
SSGGGSSGGGGGGGSEEGGGSSEEEEEESGGGGGGSS	S S G G G S S G G G G G G G S E E G G G S S E E E E E E S G G G G G G S S |
SSGGGSSSEEEGGSSGGGGGGGGGGGSSSSGGGSSSSGGGGGGGGGGGGGGGGGGGGSS	S S G G G S S S E E E G G S S G G G G G G G G G G G S S S S G G G S S S S G G G G G G G G G G G G G G G G G G G G S S |
SSGGGSSSGGEEGGGGGGSSGGGGGGGS	S S G G G S S S G G E E G G G G G G S S G G G G G G G S |
SSGGGSSSGGGGGGGGGGGGGGGEEEEEEEEEGGEEEGGGSSSEEEEEEGGGGSS	S S G G G S S S G G G G G G G G G G G G G G G E E E E E E E E E G G E E E G G G S S S E E E E E E G G G G S S |
SSGGGSSSGGGGGGGGGGSGGGGSGGGGEEGGGGGGGGGGGGGGGGGS	S S G G G S S S G G G G G G G G G G S G G G G S G G G G E E G G G G G G G G G G G G G G G G G S |
SSGGGSSSSEEGGGGGGGGGGGGGGGSS	S S G G G S S S S E E G G G G G G G G G G G G G G G S S |
SSGGGSSSSSSEEEEEEESEEGGGGGGSEEESSSEEEGGGSSSSS	S S G G G S S S S S S E E E E E E E S E E G G G G G G S E E E S S S E E E G G G S S S S S |
SSGGSEGGSSSEEEEESGGGGGGGGSSSSSGGSS	S S G G S E G G S S S E E E E E S G G G G G G G G S S S S S G G S S |
SSGGSSSGGGGGGGGSSGGGGGGGGGEEEGGGGGGGGGGSSS	S S G G S S S G G G G G G G G S S G G G G G G G G G E E E G G G G G G G G G G S S S |
SSGGSSSSSGGGEGGGGGGGSSGGGSGGGGSSSSSGGGGEEEEEESSGGGGGSS	S S G G S S S S S G G G E G G G G G G G S S G G G S G G G G S S S S S G G G G E E E E E E S S G G G G G S S |
SSSEEEEEEEEGGGGGGSSSSSSSSSSSSSSSGGGGGSGGGGGGGS	S S S E E E E E E E E G G G G G G S S S S S S S S S S S S S S S G G G G G S G G G G G G G S |
SSSEEEEEEEESSSEEEEGGGGGGGGGGGGGSGGGGGGGGGGGS	S S S E E E E E E E E S S S E E E E G G G G G G G G G G G G G S G G G G G G G G G G G S |
SSSEEEEEEGGGGGGGGGGGGGGEEEGGGGGGGGGGGGGGGSS	S S S E E E E E E G G G G G G G G G G G G G G E E E G G G G G G G G G G G G G G G S S |
SSSEEEEEEGGGGGSSSGGGGGGGGGGGGGGGGGGGGGGGGGGGGGGGGGGGGGGGGGGGGS	S S S E E E E E E G G G G G S S S G G G G G G G G G G G G G G G G G G G G G G G G G G G G G G G G G G G G G G G G G G G G S |
SSSEEEEEESEEEGGEEEGGGGGGGGGGGSS	S S S E E E E E E S E E E G G E E E G G G G G G G G G G G S S |
SSSEEEEESSGGGGGGGSGGEEGGGGSS	S S S E E E E E S S G G G G G G G S G G E E G G G G S S |
SSSEEEEGGGEGGGS	S S S E E E E G G G E G G G S |
SSSEEEEGGGGGGGGGEEGGGS	S S S E E E E G G G G G G G G G E E G G G S |
SSSEEEEGGGGGGGGGGGGGGGGGGGSS	S S S E E E E G G G G G G G G G G G G G G G G G G G S S |
SSSEEEEGGGGGGGGGSS	S S S E E E E G G G G G G G G G S S |
SSSEEEEGGGGGGSSGGGGGGGGGGGSSS	S S S E E E E G G G G G G S S G G G G G G G G G G G S S S |
SSSEEEGEGGGGSSGGGGGGGGGEEEGGGGGGGGGGGGSS	S S S E E E G E G G G G S S G G G G G G G G G E E E G G G G G G G G G G G G S S |
SSSEEEGGEEEEGGGGGGGGGGS	S S S E E E G G E E E E G G G G G G G G G G S |
SSSEEEGGESSGGGEGGGGGSGGEEEGGGGGEEEEGGSGGGGGGGGGGGGGS	S S S E E E G G E S S G G G E G G G G G S G G E E E G G G G G E E E E G G S G G G G G G G G G G G G G S |
SSSEEEGGGEEEEEGGGGGGGGGGGGSSSSSGGGGGGEGGGGS	S S S E E E G G G E E E E E G G G G G G G G G G G G S S S S S G G G G G G E G G G G S |
SSSEEEGGGEGGGGGGGGS	S S S E E E G G G E G G G G G G G G S |
SSSEEEGGGGEEEEGGGGGGGGGSS	S S S E E E G G G G E E E E G G G G G G G G G S S |
SSSEEEGGGGEESSEEGEEEEGSS	S S S E E E G G G G E E S S E E G E E E E G S S |
SSSEEEGGGGGGEGGGGGGGGGGS	S S S E E E G G G G G G E G G G G G G G G G G S |
SSSEEEGGGGGGGGEEEEGGGGSS	S S S E E E G G G G G G G G E E E E G G G G S S |
SSSEEEGGGGGGGGGGGGGGGGGGGEEEEESSEEGGGGGS	S S S E E E G G G G G G G G G G G G G G G G G G G E E E E E S S E E G G G G G S |
SSSEEEGGGGGGGGGGGGGGGGGGGGGGGGGGGGGGGGSS	S S S E E E G G G G G G G G G G G G G G G G G G G G G G G G G G G G G G G G S S |
SSSEEEGGGGGGGGGGGGGGGGGGGGGGGS	S S S E E E G G G G G G G G G G G G G G G G G G G G G G G S |
SSSEEEGGGGGGGGGGGGGGGGGGGGSSSSSGGGGGEEGGGGGGGSS	S S S E E E G G G G G G G G G G G G G G G G G G G G S S S S S G G G G G E E G G G G G G G S S |
SSSEEEGGGGGGGGGGGGGGGSS	S S S E E E G G G G G G G G G G G G G G G S S |
SSSEEEGGGGGGGGGGGGSGGGGGGGGGGGGGGGGGGSS	S S S E E E G G G G G G G G G G G G S G G G G G G G G G G G G G G G G G G S S |
SSSEEEGGGGGGGGSSGGGGGGGGGGGEGGGGGSS	S S S E E E G G G G G G G G S S G G G G G G G G G G G E G G G G G S S |
SSSEEEGGGGGGSSGGGGSEEEEGGGGGGGGGGGSSSSGGGSSSSSSGGGGGGGGGGGSS	S S S E E E G G G G G G S S G G G G S E E E E G G G G G G G G G G G S S S S G G G S S S S S S G G G G G G G G G G G S S |
SSSEEGEEGGGGGGGGGGGSS	S S S E E G E E G G G G G G G G G G G S S |
SSSEEGGEEEGGGGGGEEEGGSSGGGGGGGS	S S S E E G G E E E G G G G G G E E E G G S S G G G G G G G S |
SSSEEGGEEGGGEEEGGGGGGGGGGSS	S S S E E G G E E G G G E E E G G G G G G G G G G S S |
SSSEEGGEEGGGGGGGGS	S S S E E G G E E G G G G G G G G S |
SSSEEGGGEEEEEESEEEEEEGGGGGGGGGSSS	S S S E E G G G E E E E E E S E E E E E E G G G G G G G G G S S S |
SSSEEGGGEEEEGGEEGGGGGEGGGGGGGSS	S S S E E G G G E E E E G G E E G G G G G E G G G G G G G S S |
SSSEEGGGEEGGGGEEGEGGGGGGSS	S S S E E G G G E E G G G G E E G E G G G G G G S S |
SSSEEGGGGGEEGGGGGGGGGGGGGGGGGGGGGGGGGSS	S S S E E G G G G G E E G G G G G G G G G G G G G G G G G G G G G G G G G S S |
SSSEEGGGGGGEEEEESSEEEGGGEEES	S S S E E G G G G G G E E E E E S S E E E G G G E E E S |
SSSEEGGGGGGGEEEEEGGGGGS	S S S E E G G G G G G G E E E E E G G G G G S |
SSSEEGGGGGGGGGGEEEEGGGGGGGGGGGGGGGGGGGSSS	S S S E E G G G G G G G G G G E E E E G G G G G G G G G G G G G G G G G G G S S S |
SSSEEGGGGGGGGGGGGEEGGGGGGGGGSS	S S S E E G G G G G G G G G G G G E E G G G G G G G G G S S |
SSSEEGGGGGGGGGGGGGGEGSGGGGGGSS	S S S E E G G G G G G G G G G G G G G E G S G G G G G G S S |
SSSEEGGGGGGGGGGGGGGGGGGGGGGGGGGSSSSSEEGGGGSS	S S S E E G G G G G G G G G G G G G G G G G G G G G G G G G G S S S S S E E G G G G S S |
SSSEEGGGGGGGGGGGGGGGGGGGGSS	S S S E E G G G G G G G G G G G G G G G G G G G G S S |
SSSEEGGGGGGGGGGGGGGGS	S S S E E G G G G G G G G G G G G G G G S |
SSSEEGGGGGGGGGGGGS	S S S E E G G G G G G G G G G G G S |
SSSEEGGGGGGGGGSSS	S S S E E G G G G G G G G G S S S |
SSSEEGGGGGGSGGGGGGGGGGGGGGGGSS	S S S E E G G G G G G S G G G G G G G G G G G G G G G G S S |
SSSEEGGGGGGSSESSEEGGGGGGGGGSGGGGGGSS	S S S E E G G G G G G S S E S S E E G G G G G G G G G S G G G G G G S S |
SSSEEGGGGGSGGGGGGGGGGGGEGGGGGSS	S S S E E G G G G G S G G G G G G G G G G G G E G G G G G S S |
SSSEEGGSGGGGGGSS	S S S E E G G S G G G G G G S S |
SSSEESGGGGGGGGGGGGGEEEEESGGGGGGGGGGS	S S S E E S G G G G G G G G G G G G G E E E E E S G G G G G G G G G G S |
SSSEGGGGEEEEEEGGGGGGSS	S S S E G G G G E E E E E E G G G G G G S S |
SSSEGGGGGGGGGGGGGGGGGSSS	S S S E G G G G G G G G G G G G G G G G G S S S |
SSSEGGGGGGGGGGGGGSS	S S S E G G G G G G G G G G G G G S S |
SSSEGGGGGGGGGGSS	S S S E G G G G G G G G G G S S |
SSSEGGGGGSGSSGGEGGGSS	S S S E G G G G G S G S S G G E G G G S S |
SSSESSSGGSSGGGGGGSGGGGGGGGS	S S S E S S S G G S S G G G G G G S G G G G G G G G S |
SSSGEEEEEEEGGGGGGGGGEEEES	S S S G E E E E E E E G G G G G G G G G E E E E S |
SSSGEEEEGGGGGGGGGGGGGGGGGGGSGGGGSS	S S S G E E E E G G G G G G G G G G G G G G G G G G G S G G G G S S |
SSSGEEEEGGGGGGGSS	S S S G E E E E G G G G G G G S S |
SSSGEEEGEGGGGGGGGGGGGGGGGGSSS	S S S G E E E G E G G G G G G G G G G G G G G G G G S S S |
SSSGEEEGEGGGGGGGGGGSS	S S S G E E E G E G G G G G G G G G G S S |
SSSGEEEGGGEEEEGGGGGGGGGGGS	S S S G E E E G G G E E E E G G G G G G G G G G G S |
SSSGEEEGGGGGGGGGSS	S S S G E E E G G G G G G G G G S S |
SSSGEEESEEEGEESSSSGGGGGGS	S S S G E E E S E E E G E E S S S S G G G G G G S |
SSSGEEGEEEGSSGGGGSGGGGSSS	S S S G E E G E E E G S S G G G G S G G G G S S S |
SSSGEEGGEGGGGGGGGGGSS	S S S G E E G G E G G G G G G G G G G S S |
SSSGEEGGGGGGGGGGGGGGGGGGGGGGGGSS	S S S G E E G G G G G G G G G G G G G G G G G G G G G G G G S S |
SSSGEEGGGGGGGGGGGGSSS	S S S G E E G G G G G G G G G G G G S S S |
SSSGEEGGGSGGGGGGGGGGGSGGGEGGSSSSGGGGGGGSS	S S S G E E G G G S G G G G G G G G G G G S G G G E G G S S S S G G G G G G G S S |
SSSGEGGGGGGGGGEEGEGGGGGGGGGGGGGSS	S S S G E G G G G G G G G G E E G E G G G G G G G G G G G G G S S |
SSSGGEEEEEEGGGGGGGGGSGGEGGGSSEGGGGGGGGSS	S S S G G E E E E E E G G G G G G G G G S G G E G G G S S E G G G G G G G G S S |
SSSGGEEEEEEGGGGGSS	S S S G G E E E E E E G G G G G S S |
SSSGGEEEEGGGGEEEEGGEEEEGEEEEEGGGGEEGGGSS	S S S G G E E E E G G G G E E E E G G E E E E G E E E E E G G G G E E G G G S S |
SSSGGEEEEGGGGSS	S S S G G E E E E G G G G S S |
SSSGGEEEESSEEESSSSSEEEGGGGSSGGGGGSEEEGGSGGGGGGGGGGGSSSSGGGGGGGGGS	S S S G G E E E E S S E E E S S S S S E E E G G G G S S G G G G G S E E E G G S G G G G G G G G G G G S S S S G G G G G G G G G S |
SSSGGEEEGGEEEGGSSGGGGGGGGGGGGGGGGGGGGSS	S S S G G E E E G G E E E G G S S G G G G G G G G G G G G G G G G G G G G S S |
SSSGGEEEGGGEEEEEGGGGS	S S S G G E E E G G G E E E E E G G G G S |
SSSGGEEEGGGGGGGGGGGGGGGGGGGSS	S S S G G E E E G G G G G G G G G G G G G G G G G G G S S |
SSSGGEEEGGGGGGGGGGSS	S S S G G E E E G G G G G G G G G G S S |
SSSGGEEGESGGGGGGGGGGGGGGGSS	S S S G G E E G E S G G G G G G G G G G G G G G G S S |
SSSGGEEGGEGGEEGGGGGGEGGGSSS	S S S G G E E G G E G G E E G G G G G G E G G G S S S |
SSSGGEEGGEGGGGGGGGGGGS	S S S G G E E G G E G G G G G G G G G G G S |
SSSGGEEGGGGEEGGGGGGEEGGGGGGS	S S S G G E E G G G G E E G G G G G G E E G G G G G G S |
SSSGGEEGGGGGGGEEEGSGGGSS	S S S G G E E G G G G G G G E E E G S G G G S S |
SSSGGEEGGGGGGGGEEGGGGGGSS	S S S G G E E G G G G G G G G E E G G G G G G S S |
SSSGGEEGGGGGGGGGEEGGGGGGGSS	S S S G G E E G G G G G G G G G E E G G G G G G G S S |
SSSGGEEGGGGGGGGGGGGGGGGGGGGGGGGGGGGGGGGGGGGGS	S S S G G E E G G G G G G G G G G G G G G G G G G G G G G G G G G G G G G G G G G G G G S |
SSSGGEEGGGGGGGSSGGGSSGGGGGGS	S S S G G E E G G G G G G G S S G G G S S G G G G G G S |
SSSGGEEGGGGGGSSSSSGGGGGGGSGGGGGGGGGSS	S S S G G E E G G G G G G S S S S S G G G G G G G S G G G G G G G G G S S |
SSSGGEEGGSSSSEEEEESSSSGGGGSSSGGGGSSSGGGSSGGGGGGGGSS	S S S G G E E G G S S S S E E E E E S S S S G G G G S S S G G G G S S S G G G S S G G G G G G G G S S |
SSSGGEEGSSEEEEEGGGSGGSEEEESSGGGSSSSSGGGGGGGGGSSGGGGGGGGGGGSSS	S S S G G E E G S S E E E E E G G G S G G S E E E E S S G G G S S S S S G G G G G G G G G S S G G G G G G G G G G G S S S |
SSSGGEESSSSGGSSSSSEEEGGGGGGGGGSSSSSSSSSSSSSSSSS	S S S G G E E S S S S G G S S S S S E E E G G G G G G G G G S S S S S S S S S S S S S S S S S |
SSSGGEGEEEEEEGGGGGGGGGGGGGGGGSS	S S S G G E G E E E E E E G G G G G G G G G G G G G G G G S S |
SSSGGEGGEGGGGEGGEGGGGGS	S S S G G E G G E G G G G E G G E G G G G G S |
SSSGGEGGGEGGGGGGS	S S S G G E G G G E G G G G G G S |
SSSGGEGGGEGGGGS	S S S G G E G G G E G G G G S |
SSSGGEGGGGGGGEEGGGGGGGGGSS	S S S G G E G G G G G G G E E G G G G G G G G G S S |
SSSGGEGGGGGGGGGGGEEGGGGGGGGGGGSSSSSSSGGGGGGSS	S S S G G E G G G G G G G G G G G E E G G G G G G G G G G G S S S S S S S G G G G G G S S |
SSSGGEGGGGGGGGGGGGGGGGGGGGGG	S S S G G E G G G G G G G G G G G G G G G G G G G G G G |
SSSGGEGGGGGGGGGGGGGGGSSS	S S S G G E G G G G G G G G G G G G G G G S S S |
SSSGGEGGGGGGGGGGGSS	S S S G G E G G G G G G G G G G G S S |
SSSGGEGGGGGGGGGGGSSSGEEEEESGGGGGGGEEGGGSS	S S S G G E G G G G G G G G G G G S S S G E E E E E S G G G G G G G E E G G G S S |
SSSGGEGGGGGGGGS	S S S G G E G G G G G G G G S |
SSSGGESEEESEEGGGGGGGGGGGGGGGGGS	S S S G G E S E E E S E E G G G G G G G G G G G G G G G G G S |
SSSGGGEEEEESGGGEEGGGGGGSS	S S S G G G E E E E E S G G G E E G G G G G G S S |
SSSGGGEEEEGGGGGGGGGGGGGGGSSSGGGGGGGGSSGGGGSSEEEEEEEEGEEGGGGS	S S S G G G E E E E G G G G G G G G G G G G G G G S S S G G G G G G G G S S G G G G S S E E E E E E E E G E E G G G G S |
SSSGGGEEEEGGGGGGGGGGGGGGSS	S S S G G G E E E E G G G G G G G G G G G G G G S S |
SSSGGGEEEESSEESEEEEGGGGGGGGSSSSGGGGGGGGGGSSSSSSSGGGGGSS	S S S G G G E E E E S S E E S E E E E G G G G G G G G S S S S G G G G G G G G G G S S S S S S S G G G G G S S |
SSSGGGEEEGGGGGGGGGGGGGGGGGGGGGGGEEEGGGGGGS	S S S G G G E E E G G G G G G G G G G G G G G G G G G G G G G G E E E G G G G G G S |
SSSGGGEEEGGGGGGGGGGGGGSGGGGGGGGGSGGGGGGGGGGGGGGGS	S S S G G G E E E G G G G G G G G G G G G G S G G G G G G G G G S G G G G G G G G G G G G G G G S |
SSSGGGEEEGGGGS	S S S G G G E E E G G G G S |
SSSGGGEEEGGGSGGGGGGS	S S S G G G E E E G G G S G G G G G G S |
SSSGGGEEESGGGEGEESSSSSSGSSSSSEEEGGGGSS	S S S G G G E E E S G G G E G E E S S S S S S G S S S S S E E E G G G G S S |
SSSGGGEEGGGGGGGGGGGGGGGGGGGGGGSGGGGGGGGSS	S S S G G G E E G G G G G G G G G G G G G G G G G G G G G G S G G G G G G G G S S |
SSSGGGEEGGGGGGGGGGGGGGGGGGGSS	S S S G G G E E G G G G G G G G G G G G G G G G G G G S S |
SSSGGGEEGGGGGGGGGGGGGGGGGS	S S S G G G E E G G G G G G G G G G G G G G G G G S |
SSSGGGEEGGGGGGGGGGGGGGGGGSS	S S S G G G E E G G G G G G G G G G G G G G G G G S S |
SSSGGGEEGGGGGGGGGGGGGGSSS	S S S G G G E E G G G G G G G G G G G G G G S S S |
SSSGGGEEGGGGGGGGGGGGS	S S S G G G E E G G G G G G G G G G G G S |
SSSGGGEEGGGGGGSGGGGGS	S S S G G G E E G G G G G G S G G G G G S |
SSSGGGEEGGSEEEGGGGGGGGS	S S S G G G E E G G S E E E G G G G G G G G S |
SSSGGGEEGGSEEGGGGGGGGGGGGGEEEGGGGSS	S S S G G G E E G G S E E G G G G G G G G G G G G G E E E G G G G S S |
SSSGGGEGGGGGGGGGGGGGSS	S S S G G G E G G G G G G G G G G G G G S S |
SSSGGGEGGGGGGGGGSGGGGGGGSGGGGGGGSSS	S S S G G G E G G G G G G G G G S G G G G G G G S G G G G G G G S S S |
SSSGGGEGGGGGGGSSS	S S S G G G E G G G G G G G S S S |
SSSGGGGEEEEEEEEEEGGGGGSS	S S S G G G G E E E E E E E E E E G G G G G S S |
SSSGGGGEEEEEEGGGGGGSS	S S S G G G G E E E E E E G G G G G G S S |
SSSGGGGEEEEEESSSGGGGSSGGGSEESEEGSSSEEESS	S S S G G G G E E E E E E S S S G G G G S S G G G S E E S E E G S S S E E E S S |
SSSGGGGEEEEGGGGGGGGGGS	S S S G G G G E E E E G G G G G G G G G G S |
SSSGGGGEEEEGSSSSGGGGSGGGSGGGGSSSSSSSSGGGGGGGGGGGGGGGGGSS	S S S G G G G E E E E G S S S S G G G G S G G G S G G G G S S S S S S S S G G G G G G G G G G G G G G G G G S S |
SSSGGGGEEEGEEGEEEEGGGGGGGGS	S S S G G G G E E E G E E G E E E E G G G G G G G G S |
SSSGGGGEEEGGGEGGGGGGGGGGGGGSSS	S S S G G G G E E E G G G E G G G G G G G G G G G G G S S S |
SSSGGGGEEEGGGGGGGGGGGGSS	S S S G G G G E E E G G G G G G G G G G G G S S |
SSSGGGGEEEGGGGGGGGGSS	S S S G G G G E E E G G G G G G G G G S S |
SSSGGGGEEEGGGGGGGSS	S S S G G G G E E E G G G G G G G S S |
SSSGGGGEEEGGGGGSSGGGGGS	S S S G G G G E E E G G G G G S S G G G G G S |
SSSGGGGEEGGEGGGGGGGGGGS	S S S G G G G E E G G E G G G G G G G G G G S |
SSSGGGGEEGGGGEEEGGGGGGGGGGSEEEG	S S S G G G G E E G G G G E E E G G G G G G G G G G S E E E G |
SSSGGGGEEGGGGGEEGGGS	S S S G G G G E E G G G G G E E G G G S |
SSSGGGGEEGGGGGEEGGGSSEEESSEEEESSGGGGGGGGSS	S S S G G G G E E G G G G G E E G G G S S E E E S S E E E E S S G G G G G G G G S S |
SSSGGGGEEGGGGGGGGGGGGGGGGGGGSGGGGGGGSS	S S S G G G G E E G G G G G G G G G G G G G G G G G G G S G G G G G G G S S |
SSSGGGGEEGGGGGGGGGGGGGGGGSGGGGGSSGGGGGGGGGSSSGGGGSS	S S S G G G G E E G G G G G G G G G G G G G G G G S G G G G G S S G G G G G G G G G S S S G G G G S S |
SSSGGGGEEGGGGGGGGGGGGGSS	S S S G G G G E E G G G G G G G G G G G G G S S |
SSSGGGGEEGGGGGGGGGGSSS	S S S G G G G E E G G G G G G G G G G S S S |
SSSGGGGEEGGGGGGGSEEEEEEEEGGGEEEEGEEGGGSS	S S S G G G G E E G G G G G G G S E E E E E E E E G G G E E E E G E E G G G S S |
SSSGGGGEEGGGGSGGGGGGGGGGGSS	S S S G G G G E E G G G G S G G G G G G G G G G G S S |
SSSGGGGEESSGGSGGGGGGGGGGGGGGSSSSGGGGGS	S S S G G G G E E S S G G S G G G G G G G G G G G G G G S S S S G G G G G S |
SSSGGGGEESSSGGGGGGGGGGGGGGSGGGGGGGSS	S S S G G G G E E S S S G G G G G G G G G G G G G G S G G G G G G G S S |
SSSGGGGEGGGGGGGGGGGGGGGGGS	S S S G G G G E G G G G G G G G G G G G G G G G G S |
SSSGGGGEGGGGGGGGGGGGGGSS	S S S G G G G E G G G G G G G G G G G G G G S S |
SSSGGGGEGGGGGGGGGGGS	S S S G G G G E G G G G G G G G G G G S |
SSSGGGGEGGGGGGGGS	S S S G G G G E G G G G G G G G S |
SSSGGGGEGGGGGGGSS	S S S G G G G E G G G G G G G S S |
SSSGGGGESSSSGEGGG	S S S G G G G E S S S S G E G G G |
SSSGGGGGEEEEEEGGGGGEEEGGGGGGGGSSS	S S S G G G G G E E E E E E G G G G G E E E G G G G G G G G S S S |
SSSGGGGGEEEEEESSS	S S S G G G G G E E E E E E S S S |
SSSGGGGGEEEEEGGEEEEGGGGGS	S S S G G G G G E E E E E G G E E E E G G G G G S |
SSSGGGGGEEEEGGGGSS	S S S G G G G G E E E E G G G G S S |
SSSGGGGGEEEEGSGGGGGGGGGGGSS	S S S G G G G G E E E E G S G G G G G G G G G G G S S |
SSSGGGGGEEEGGGGGGGGGGGGGGGGGGGSGGGSSS	S S S G G G G G E E E G G G G G G G G G G G G G G G G G G G S G G G S S S |
SSSGGGGGEEEGGGGGGGGGGGSS	S S S G G G G G E E E G G G G G G G G G G G S S |
SSSGGGGGEEEGGGGGGSGEEEGGSEEGGSSGGGGSSGGGGGGGGS	S S S G G G G G E E E G G G G G G S G E E E G G S E E G G S S G G G G S S G G G G G G G G S |
SSSGGGGGEEESGGGEEEGGGGGGGGGGGGGGGGGSSSS	S S S G G G G G E E E S G G G E E E G G G G G G G G G G G G G G G G G S S S S |
SSSGGGGGEEGGGGGGGGGGGGGGGGGGGSS	S S S G G G G G E E G G G G G G G G G G G G G G G G G G G S S |
SSSGGGGGEEGGGGGGGGGGGGGGS	S S S G G G G G E E G G G G G G G G G G G G G G S |
SSSGGGGGEEGGGGGGGGSS	S S S G G G G G E E G G G G G G G G S S |
SSSGGGGGEEGGGGGGGGSSGGGGGGGGGGGGGSS	S S S G G G G G E E G G G G G G G G S S G G G G G G G G G G G G G S S |
SSSGGGGGEEGGGGGGGGSSSSSGGGGGGGGGGGGSS	S S S G G G G G E E G G G G G G G G S S S S S G G G G G G G G G G G G S S |
SSSGGGGGEEGGGGGGGSSSGGGGGSSSGGGGS	S S S G G G G G E E G G G G G G G S S S G G G G G S S S G G G G S |
SSSGGGGGEEGGGGGSS	S S S G G G G G E E G G G G G S S |
SSSGGGGGEGGGGGGGGGGGGGGGGGGGGS	S S S G G G G G E G G G G G G G G G G G G G G G G G G G G S |
SSSGGGGGGEEEEESEEEEEEEGGSSSSSSSSEEEEEEEGGGGGGGGGGGGGGGGGGS	S S S G G G G G G E E E E E S E E E E E E E G G S S S S S S S S E E E E E E E G G G G G G G G G G G G G G G G G G S |
SSSGGGGGGEEEEESGGGGGSSGGGGGGGGGGGGGSSGGGGGSS	S S S G G G G G G E E E E E S G G G G G S S G G G G G G G G G G G G G S S G G G G G S S |
SSSGGGGGGEEEGGGGGGGGGGGGGGGGGGGEEGGGGSGGGGSS	S S S G G G G G G E E E G G G G G G G G G G G G G G G G G G G E E G G G G S G G G G S S |
SSSGGGGGGEEEGGGGGGGGGGGGGGGGGGGSS	S S S G G G G G G E E E G G G G G G G G G G G G G G G G G G G S S |
SSSGGGGGGEEEGGGGGGGGGGGGSS	S S S G G G G G G E E E G G G G G G G G G G G G S S |
SSSGGGGGGEEGGEESS	S S S G G G G G G E E G G E E S S |
SSSGGGGGGEEGGGGEGGGGGGSS	S S S G G G G G G E E G G G G E G G G G G G S S |
SSSGGGGGGEEGGGGGGGGGGS	S S S G G G G G G E E G G G G G G G G G G S |
SSSGGGGGGEGGGGGGGSGGGGGGGGGS	S S S G G G G G G E G G G G G G G S G G G G G G G G G S |
SSSGGGGGGEGGGGGSS	S S S G G G G G G E G G G G G S S |
SSSGGGGGGGEEEEEEGGGGS	S S S G G G G G G G E E E E E E G G G G S |
SSSGGGGGGGEEEEEGGGG	S S S G G G G G G G E E E E E G G G G |
SSSGGGGGGGEEEEGGGGGGGGSGGGGGSS	S S S G G G G G G G E E E E G G G G G G G G S G G G G G S S |
SSSGGGGGGGEEEEGGSGGGGGGGGS	S S S G G G G G G G E E E E G G S G G G G G G G G S |
SSSGGGGGGGEEEGGGGGSGGGGGGGGGGGGGGGGSSS	S S S G G G G G G G E E E G G G G G S G G G G G G G G G G G G G G G G S S S |
SSSGGGGGGGEEGGEEEEGGGGGGGGGSS	S S S G G G G G G G E E G G E E E E G G G G G G G G G S S |
SSSGGGGGGGEEGGGGGGGGGGGGGGGEEEGGEGGGGGGGGSGGGGSS	S S S G G G G G G G E E G G G G G G G G G G G G G G G E E E G G E G G G G G G G G S G G G G S S |
SSSGGGGGGGEEGGGGGGGGGSS	S S S G G G G G G G E E G G G G G G G G G S S |
SSSGGGGGGGEEGGGGGGGGSS	S S S G G G G G G G E E G G G G G G G G S S |
SSSGGGGGGGEEGGGGGSS	S S S G G G G G G G E E G G G G G S S |
SSSGGGGGGGEEGGSS	S S S G G G G G G G E E G G S S |
SSSGGGGGGGEGEESEEEGGGGGGGGSS	S S S G G G G G G G E G E E S E E E G G G G G G G G S S |
SSSGGGGGGGEGGGEGGGGS	S S S G G G G G G G E G G G E G G G G S |
SSSGGGGGGGEGGGGGGGGGGGGGGSS	S S S G G G G G G G E G G G G G G G G G G G G G G S S |
SSSGGGGGGGEGGGSS	S S S G G G G G G G E G G G S S |
SSSGGGGGGGGEEEEEEESSSSSEESEEEESGGGGGGGGGGGGGGGGGSS	S S S G G G G G G G G E E E E E E E S S S S S E E S E E E E S G G G G G G G G G G G G G G G G G S S |
SSSGGGGGGGGEEEEGGEEEEGGGGGS	S S S G G G G G G G G E E E E G G E E E E G G G G G S |
SSSGGGGGGGGEEEGGGGGEEGGSS	S S S G G G G G G G G E E E G G G G G E E G G S S |
SSSGGGGGGGGEEEGGGGGGGGGGGGGGGGGGSS	S S S G G G G G G G G E E E G G G G G G G G G G G G G G G G G G S S |
SSSGGGGGGGGEEEGGGGGS	S S S G G G G G G G G E E E G G G G G S |
SSSGGGGGGGGEEEGGGSSGGGGSSSSSS	S S S G G G G G G G G E E E G G G S S G G G G S S S S S S |
SSSGGGGGGGGEEESGGGGGGGGGSS	S S S G G G G G G G G E E E S G G G G G G G G G S S |
SSSGGGGGGGGEEGEGGGGGGGGGGGGGGGSS	S S S G G G G G G G G E E G E G G G G G G G G G G G G G G G S S |
SSSGGGGGGGGEEGGGGGGGGGGGGGGSGGGGGGGGGGGGGSSSSSS	S S S G G G G G G G G E E G G G G G G G G G G G G G G S G G G G G G G G G G G G G S S S S S S |
SSSGGGGGGGGEEGGGGGGGGGGGGGGSS	S S S G G G G G G G G E E G G G G G G G G G G G G G G S S |
SSSGGGGGGGGEEGGGGGGGGGGGGSS	S S S G G G G G G G G E E G G G G G G G G G G G G S S |
SSSGGGGGGGGEEGGGGGGGGGGGSS	S S S G G G G G G G G E E G G G G G G G G G G G S S |
SSSGGGGGGGGEEGGGGGGGSGGGS	S S S G G G G G G G G E E G G G G G G G S G G G S |
SSSGGGGGGGGEEGGGSSSGGGGGGGGGSS	S S S G G G G G G G G E E G G G S S S G G G G G G G G G S S |
SSSGGGGGGGGEGEEGGGSS	S S S G G G G G G G G E G E E G G G S S |
SSSGGGGGGGGEGGGGGGGGEGGGGGGGGGGGGGSS	S S S G G G G G G G G E G G G G G G G G E G G G G G G G G G G G G G S S |
SSSGGGGGGGGEGGGGSS	S S S G G G G G G G G E G G G G S S |
SSSGGGGGGGGGEEEEGGSGGGGGGGGGGGGGGGGGGSS	S S S G G G G G G G G G E E E E G G S G G G G G G G G G G G G G G G G G G S S |
SSSGGGGGGGGGEEEGGGGGGGGGGGGGGS	S S S G G G G G G G G G E E E G G G G G G G G G G G G G G S |
SSSGGGGGGGGGEEEGGGGGGGGGSS	S S S G G G G G G G G G E E E G G G G G G G G G S S |
SSSGGGGGGGGGEEGGGGGGGGGSS	S S S G G G G G G G G G E E G G G G G G G G G S S |
SSSGGGGGGGGGEEGGGGSS	S S S G G G G G G G G G E E G G G G S S |
SSSGGGGGGGGGEEGGSS	S S S G G G G G G G G G E E G G S S |
SSSGGGGGGGGGEGGGGGGGGGGEEGGGGSGGGGGGGGGGSS	S S S G G G G G G G G G E G G G G G G G G G G E E G G G G S G G G G G G G G G G S S |
SSSGGGGGGGGGEGGGGGGGGGSGGGGGGGGGGGGGGSS	S S S G G G G G G G G G E G G G G G G G G G S G G G G G G G G G G G G G G S S |
SSSGGGGGGGGGESGGGGGGGGGGGGGGGGGGGGSS	S S S G G G G G G G G G E S G G G G G G G G G G G G G G G G G G G G S S |
SSSGGGGGGGGGGEEEEEEEEGGGGGGSSSSGGGSSGGGGGSGGGGGGGSSGGGGGGGGGS	S S S G G G G G G G G G G E E E E E E E E G G G G G G S S S S G G G S S G G G G G S G G G G G G G S S G G G G G G G G G S |
SSSGGGGGGGGGGEEEEEGGGGGGSS	S S S G G G G G G G G G G E E E E E G G G G G G S S |
SSSGGGGGGGGGGEEEGGGGEGGGGGGGS	S S S G G G G G G G G G G E E E G G G G E G G G G G G G S |
SSSGGGGGGGGGGEEEGGGGGGGS	S S S G G G G G G G G G G E E E G G G G G G G S |
SSSGGGGGGGGGGEEEGGGGGGGSS	S S S G G G G G G G G G G E E E G G G G G G G S S |
SSSGGGGGGGGGGEEGGGGS	S S S G G G G G G G G G G E E G G G G S |
SSSGGGGGGGGGGEEGGGGSS	S S S G G G G G G G G G G E E G G G G S S |
SSSGGGGGGGGGGGEEEEEGGGGGSS	S S S G G G G G G G G G G G E E E E E G G G G G S S |
SSSGGGGGGGGGGGEEEESEEEEEEES	S S S G G G G G G G G G G G E E E E S E E E E E E E S |
SSSGGGGGGGGGGGEEEGGGGGEGGGGGGGSS	S S S G G G G G G G G G G G E E E G G G G G E G G G G G G G S S |
SSSGGGGGGGGGGGEEEGGGGGEGGGGSS	S S S G G G G G G G G G G G E E E G G G G G E G G G G S S |
SSSGGGGGGGGGGGEEEGGS	S S S G G G G G G G G G G G E E E G G S |
SSSGGGGGGGGGGGEEGGGGGSS	S S S G G G G G G G G G G G E E G G G G G S S |
SSSGGGGGGGGGGGEGGGSS	S S S G G G G G G G G G G G E G G G S S |
SSSGGGGGGGGGGGGEEEGGGGGGGGGSGGGGGGGSSSS	S S S G G G G G G G G G G G G E E E G G G G G G G G G S G G G G G G G S S S S |
SSSGGGGGGGGGGGGEEEGGGGGSS	S S S G G G G G G G G G G G G E E E G G G G G S S |
SSSGGGGGGGGGGGGEEEGGSSGGGGGGGGGGS	S S S G G G G G G G G G G G G E E E G G S S G G G G G G G G G G S |
SSSGGGGGGGGGGGGGEEGGGGGS	S S S G G G G G G G G G G G G G E E G G G G G S |
SSSGGGGGGGGGGGGGGEEEGGGGEEGGGGGGGGGS	S S S G G G G G G G G G G G G G G E E E G G G G E E G G G G G G G G G S |
SSSGGGGGGGGGGGGGGEGGGGGGGGGGSS	S S S G G G G G G G G G G G G G G E G G G G G G G G G G S S |
SSSGGGGGGGGGGGGGGGEEEGGGGGGGGSS	S S S G G G G G G G G G G G G G G G E E E G G G G G G G G S S |
SSSGGGGGGGGGGGGGGGEEGGGGGGGGS	S S S G G G G G G G G G G G G G G G E E G G G G G G G G S |
SSSGGGGGGGGGGGGGGGEEGGGGS	S S S G G G G G G G G G G G G G G G E E G G G G S |
SSSGGGGGGGGGGGGGGGEEGGGGSS	S S S G G G G G G G G G G G G G G G E E G G G G S S |
SSSGGGGGGGGGGGGGGGEGGGGSS	S S S G G G G G G G G G G G G G G G E G G G G S S |
SSSGGGGGGGGGGGGGGGGEEEEGGGGGGGGGGGGGGSS	S S S G G G G G G G G G G G G G G G G E E E E G G G G G G G G G G G G G G S S |
SSSGGGGGGGGGGGGGGGGEEEGG	S S S G G G G G G G G G G G G G G G G E E E G G |
SSSGGGGGGGGGGGGGGGGEEGGGGGGGGGSS	S S S G G G G G G G G G G G G G G G G E E G G G G G G G G G S S |
SSSGGGGGGGGGGGGGGGGGEEGGGGGGGGGGGGGSS	S S S G G G G G G G G G G G G G G G G G E E G G G G G G G G G G G G G S S |
SSSGGGGGGGGGGGGGGGGGEEGGGSSEEGGGGGGGGGGGGGGS	S S S G G G G G G G G G G G G G G G G G E E G G G S S E E G G G G G G G G G G G G G G S |
SSSGGGGGGGGGGGGGGGGGEGGGGGGGGGSS	S S S G G G G G G G G G G G G G G G G G E G G G G G G G G G S S |
SSSGGGGGGGGGGGGGGGGGGEESSEEGGSSSSSGGGGS	S S S G G G G G G G G G G G G G G G G G G E E S S E E G G S S S S S G G G G S |
SSSGGGGGGGGGGGGGGGGGGGGGEEESGGGGGGGSSSGEEEGGGGGGGS	S S S G G G G G G G G G G G G G G G G G G G G G E E E S G G G G G G G S S S G E E E G G G G G G G S |
SSSGGGGGGGGGGGGGGGGGGGGGEEGGGGGGS	S S S G G G G G G G G G G G G G G G G G G G G G E E G G G G G G S |
SSSGGGGGGGGGGGGGGGGGGGGGGEEGGGGGGGGS	S S S G G G G G G G G G G G G G G G G G G G G G G E E G G G G G G G G S |
SSSGGGGGGGGGGGGGGGGGGGGGGGGEEGGGGGGSS	S S S G G G G G G G G G G G G G G G G G G G G G G G G E E G G G G G G S S |
SSSGGGGGGGGGGGGGGGGGGGGGGGGGGGEGGGGGEESGGGGGGGGS	S S S G G G G G G G G G G G G G G G G G G G G G G G G G G G E G G G G G E E S G G G G G G G G S |
SSSGGGGGGGGGGGGGGGGGGGGGGGGGGGGGGGGGGEGGGS	S S S G G G G G G G G G G G G G G G G G G G G G G G G G G G G G G G G G G E G G G S |
SSSGGGGGGGGGGGGGGGGGGGGGGGSSSSEEEEEEEEESGGSSGGGSGGGGGS	S S S G G G G G G G G G G G G G G G G G G G G G G G S S S S E E E E E E E E E S G G S S G G G S G G G G G S |
SSSGGGGGGGGGGGGGGGGGGGGGGSEEEEEGGGGGGGGSSEEGSSSSSSSSSGGGGGGGGGGS	S S S G G G G G G G G G G G G G G G G G G G G G G S E E E E E G G G G G G G G S S E E G S S S S S S S S S G G G G G G G G G G S |
SSSGGGGGGGGGGGGGGGGGGGGGSSGGGGGSEEEEEEEGGGGGGGS	S S S G G G G G G G G G G G G G G G G G G G G G S S G G G G G S E E E E E E E G G G G G G G S |
SSSGGGGGGGGGGGGGGGGGGGGGSSSSSGEEEGGSS	S S S G G G G G G G G G G G G G G G G G G G G G S S S S S G E E E G G S S |
SSSGGGGGGGGGGGGGGGGGGSEEEEEGEEEGGGGGGS	S S S G G G G G G G G G G G G G G G G G G S E E E E E G E E E G G G G G G S |
SSSGGGGGGGGGGGGGGGGGGSEEESGGGSS	S S S G G G G G G G G G G G G G G G G G G S E E E S G G G S S |
SSSGGGGGGGGGGGGGGGGGGSGGGGGGGGSSSEEEEGSGGGGGG	S S S G G G G G G G G G G G G G G G G G G S G G G G G G G G S S S E E E E G S G G G G G G |
SSSGGGGGGGGGGGGGGGGSGGGGGGGEEGGGGGSGGGGGGGGSS	S S S G G G G G G G G G G G G G G G G S G G G G G G G E E G G G G G S G G G G G G G G S S |
SSSGGGGGGGGGGGGGGGGSGGGGGGGGGGGGSGGSGGGSEGGGGGGGGS	S S S G G G G G G G G G G G G G G G G S G G G G G G G G G G G G S G G S G G G S E G G G G G G G G S |
SSSGGGGGGGGGGGGGGGS	S S S G G G G G G G G G G G G G G G S |
SSSGGGGGGGGGGGGGGSGGGGGGGGGGGGGGGSGGGGGGSEEEEEEEGGGGGGGSS	S S S G G G G G G G G G G G G G G S G G G G G G G G G G G G G G G S G G G G G G S E E E E E E E G G G G G G G S S |
SSSGGGGGGGGGGGGGGSSGGGGGGGGGGGGGGEEEGGGGGGGGGGGGGGGGGGS	S S S G G G G G G G G G G G G G G S S G G G G G G G G G G G G G G E E E G G G G G G G G G G G G G G G G G G S |
SSSGGGGGGGGGGGGGSEEGG	S S S G G G G G G G G G G G G G S E E G G |
SSSGGGGGGGGGGGGGSEES	S S S G G G G G G G G G G G G G S E E S |
SSSGGGGGGGGGGGGGSGGGEGGGGEGGGGGGGGS	S S S G G G G G G G G G G G G G S G G G E G G G G E G G G G G G G G S |
SSSGGGGGGGGGGGGGSGSGGSSGGGSS	S S S G G G G G G G G G G G G G S G S G G S S G G G S S |
SSSGGGGGGGGGGGGSEEGGGSSSGGGGGGGGGGSS	S S S G G G G G G G G G G G G S E E G G G S S S G G G G G G G G G G S S |
SSSGGGGGGGGGGGGSSEEEES	S S S G G G G G G G G G G G G S S E E E E S |
SSSGGGGGGGGGGGGSSGGGGGGGGGGEEEEEEGGGGGSGGGGGGGGGGGGGGGS	S S S G G G G G G G G G G G G S S G G G G G G G G G G E E E E E E G G G G G S G G G G G G G G G G G G G G G S |
SSSGGGGGGGGGGGGSSGGGSSSSGGGGGGGGGGSGGGGGEEEGGGSGGGGSGGSS	S S S G G G G G G G G G G G G S S G G G S S S S G G G G G G G G G G S G G G G G E E E G G G S G G G G S G G S S |
SSSGGGGGGGGGGGGSSSSGGGGGGGGGGGSSSEEEEGGGGGEESSSGGGGGSS	S S S G G G G G G G G G G G G S S S S G G G G G G G G G G G S S S E E E E G G G G G E E S S S G G G G G S S |
SSSGGGGGGGGGGGSSSSGGSSEGSSGGGGGGGGGGGGGGGGGGS	S S S G G G G G G G G G G G S S S S G G S S E G S S G G G G G G G G G G G G G G G G G G S |
SSSGGGGGGGGGGSGGGGGSGGGGGGGSSSSGGGGGGGGGGSSEEGGSSGGGGGGGGGSS	S S S G G G G G G G G G G S G G G G G S G G G G G G G S S S S G G G G G G G G G G S S E E G G S S G G G G G G G G G S S |
SSSGGGGGGGGGSGGGGGGGEEEGSGGGGGGGGGGGGGGGGS	S S S G G G G G G G G G S G G G G G G G E E E G S G G G G G G G G G G G G G G G G S |
SSSGGGGGGGGGSSGGGEGGGGGSS	S S S G G G G G G G G G S S G G G E G G G G G S S |
SSSGGGGGGGGGSSSEEEEGGGGGGGGSSSSGGGGGGGGGGGGGGGGGGGSGGGGGGGGGGGSS	S S S G G G G G G G G G S S S E E E E G G G G G G G G S S S S G G G G G G G G G G G G G G G G G G G S G G G G G G G G G G G S S |
SSSGGGGGGGGGSSSSEEGGGSGGGGGGGSS	S S S G G G G G G G G G S S S S E E G G G S G G G G G G G S S |
SSSGGGGGGGGSGGSEEEGGGGGGGGGGGSS	S S S G G G G G G G G S G G S E E E G G G G G G G G G G G S S |
SSSGGGGGGGGSGGSGGEESSSSGGGGGGGGGGGGGS	S S S G G G G G G G G S G G S G G E E S S S S G G G G G G G G G G G G G S |
SSSGGGGGGGGSGSGGGGGSSSSSGGEEEGGGGGGGGGGGS	S S S G G G G G G G G S G S G G G G G S S S S S G G E E E G G G G G G G G G G G S |
SSSGGGGGGGGSSSEEESGGGGSSS	S S S G G G G G G G G S S S E E E S G G G G S S S |
SSSGGGGGGGGSSSSEEEGGGGGGGGGGGGGGGGGGGGGGSS	S S S G G G G G G G G S S S S E E E G G G G G G G G G G G G G G G G G G G G G G S S |
SSSGGGGGGGSEEEEEEEGGGGSS	S S S G G G G G G G S E E E E E E E G G G G S S |
SSSGGGGGGGSSEEEGGGGGGGEEEEEEEGGGGGGGGGGGGGGGSSGGGGGSS	S S S G G G G G G G S S E E E G G G G G G G E E E E E E E G G G G G G G G G G G G G G G S S G G G G G S S |
SSSGGGGGGGSSGGEEGGGGGGGGGGSS	S S S G G G G G G G S S G G E E G G G G G G G G G G S S |
SSSGGGGGGGSSSEESSSGGGGSSEEEEEGSGGGGSGGGGGGGSSS	S S S G G G G G G G S S S E E S S S G G G G S S E E E E E G S G G G G S G G G G G G G S S S |
SSSGGGGGGSEEEGGSEEEGGGGGGGGSGGGGGGGGGGGGGGEEEESGGGSSS	S S S G G G G G G S E E E G G S E E E G G G G G G G G S G G G G G G G G G G G G G G E E E E S G G G S S S |
SSSGGGGGGSEGGGGGGGGGGGGGGSS	S S S G G G G G G S E G G G G G G G G G G G G G G S S |
SSSGGGGGGSSSGGGGGGGGEEEGGGGSS	S S S G G G G G G S S S G G G G G G G G E E E G G G G S S |
SSSGGGGGGSSSSGGGGGGGGSGGGEEEEGGGGGSS	S S S G G G G G G S S S S G G G G G G G G S G G G E E E E G G G G G S S |
SSSGGGGGSGGGGGGGSEEGGGGGGGGGGGS	S S S G G G G G S G G G G G G G S E E G G G G G G G G G G G S |
SSSGGGGGSSEEGGSSGGGGGGSSS	S S S G G G G G S S E E G G S S G G G G G G S S S |
SSSGGGGSEEEEESEEEEEGGGGSS	S S S G G G G S E E E E E S E E E E E G G G G S S |
SSSGGGGSEESSEEEGGGEEGGGGGGGGGGGGGGGGGGGSSS	S S S G G G G S E E S S E E E G G G E E G G G G G G G G G G G G G G G G G G G S S S |
SSSGGGGSGGGGGEEGGGGGGGEEGGGGGGGSSS	S S S G G G G S G G G G G E E G G G G G G G E E G G G G G G G S S S |
SSSGGGGSGGGGGGSGGGGGGGGGEEEEEEGGSSSGGGGGGGSS	S S S G G G G S G G G G G G S G G G G G G G G G E E E E E E G G S S S G G G G G G G S S |
SSSGGGGSSGGGGGGEEGGGGGSS	S S S G G G G S S G G G G G G E E G G G G G S S |
SSSGGGGSSSGGGGGGGGEEEGGGGGS	S S S G G G G S S S G G G G G G G G E E E G G G G G S |
SSSGGGGSSSSGGGGGGEEEGGSSGGGSSSSSGGGGSS	S S S G G G G S S S S G G G G G G E E E G G S S G G G S S S S S G G G G S S |
SSSGGGSEEGGGGGGGGSGGGGGGS	S S S G G G S E E G G G G G G G G S G G G G G G S |
SSSGGGSGGGEEGGGGGGS	S S S G G G S G G G E E G G G G G G S |
SSSGGGSGGGGGGGGGGGEEGGGSSGGGEGGGGGGGGSS	S S S G G G S G G G G G G G G G G G E E G G G S S G G G E G G G G G G G G S S |
SSSGGGSGGGGGGGGGGGGGGGGGEEEEEGGGGGGGGGSGGGGGGGGGGSS	S S S G G G S G G G G G G G G G G G G G G G G G E E E E E G G G G G G G G G S G G G G G G G G G G S S |
SSSGGGSGGGSEEGGGGGGGGSGGGSS	S S S G G G S G G G S E E G G G G G G G G S G G G S S |
SSSGGGSGGSSSGGGGGGGGGGEEEGGGGGGGGGGSSS	S S S G G G S G G S S S G G G G G G G G G G E E E G G G G G G G G G G S S S |
SSSGGGSSGGGGGGGEGGGGGGGEEGGGGGGSS	S S S G G G S S G G G G G G G E G G G G G G G E E G G G G G G S S |
SSSGGGSSGGGSGGSEEGGGGGGGGGGGGGSS	S S S G G G S S G G G S G G S E E G G G G G G G G G G G G G S S |
SSSGGGSSSGGGGGGGGGGGGGEEEEEGGSSEEEGGGGGGGGGGSS	S S S G G G S S S G G G G G G G G G G G G G E E E E E G G S S E E E G G G G G G G G G G S S |
SSSGGGSSSGGGSGGGEGGSGGGGGGSSSS	S S S G G G S S S G G G S G G G E G G S G G G G G G S S S S |
SSSGGGSSSSGGGGGGGGGGGGEGGGGGGSS	S S S G G G S S S S G G G G G G G G G G G G E G G G G G G S S |
SSSGGSEEEEESSSGGGGGGGGGGSSGGGGGGSSSSGGGGGGGGGGGGGGGGSSGGGGGGGGGGSGGGGGGSSSSSSSSSGGGGGGGGGSS	S S S G G S E E E E E S S S G G G G G G G G G G S S G G G G G G S S S S G G G G G G G G G G G G G G G G S S G G G G G G G G G G S G G G G G G S S S S S S S S S G G G G G G G G G S S |
SSSSEEEEEEEEEEEGEEEEEEESGGGEEEEGGGGGGS	S S S S E E E E E E E E E E E G E E E E E E E S G G G E E E E G G G G G G S |
SSSSEEEEEEEEEGGGGGGGGGSSSEEEESSSESSSGGGGGGGGGGGGGGGSS	S S S S E E E E E E E E E G G G G G G G G G S S S E E E E S S S E S S S G G G G G G G G G G G G G G G S S |
SSSSEEEEEEEEGGGGGGGGGGGGGGGGGS	S S S S E E E E E E E E G G G G G G G G G G G G G G G G G S |
SSSSEEEEEEEESSEEEGGGSSSSSSGGGGGGGGSS	S S S S E E E E E E E E S S E E E G G G S S S S S S G G G G G G G G S S |
SSSSEEEEEEEGGGGSSGGGGGGGGGSS	S S S S E E E E E E E G G G G S S G G G G G G G G G S S |
SSSSEEEEEEEGGGSSGGGSSSEEGGGGGGGGSSSGGGSS	S S S S E E E E E E E G G G S S G G G S S S E E G G G G G G G G S S S G G G S S |
SSSSEEEEEGEGGGGSSEEEGGGGSS	S S S S E E E E E G E G G G G S S E E E G G G G S S |
SSSSEEEEGGEEEEGEEEEEEEGSGGGGGGGSSGGGGGGSSSS	S S S S E E E E G G E E E E G E E E E E E E G S G G G G G G G S S G G G G G G S S S S |
SSSSEEEGGGEEGGGGGGGGSEEEEEGGGGGSSGGGGGGGSSS	S S S S E E E G G G E E G G G G G G G G S E E E E E G G G G G S S G G G G G G G S S S |
SSSSEEEGGGGGGGGGGGGSGGGGGGGGSGGGGGGGGGGGGSSSSSSSSSGGGGGGGGGGS	S S S S E E E G G G G G G G G G G G G S G G G G G G G G S G G G G G G G G G G G G S S S S S S S S S G G G G G G G G G G S |
SSSSEEEGGGGGGGGGSSSSGGEEESSGGGGGGGGGGGGGGSS	S S S S E E E G G G G G G G G G S S S S G G E E E S S G G G G G G G G G G G G G G S S |
SSSSEEGEEGGGGGGSSSSSSGGGGGGGGGGGSS	S S S S E E G E E G G G G G G S S S S S S G G G G G G G G G G G S S |
SSSSEEGGGGEEEEGGGGGGGGSS	S S S S E E G G G G E E E E G G G G G G G G S S |
SSSSEEGGGGEEEGSS	S S S S E E G G G G E E E G S S |
SSSSEEGGGGGGGGGGGGGGGGGGGGGGGGSGGGGGGGGGGGGGGGSS	S S S S E E G G G G G G G G G G G G G G G G G G G G G G G G S G G G G G G G G G G G G G G G S S |
SSSSEEGGGGGGGGGGGGSSGGGGGGGGGGGGGSS	S S S S E E G G G G G G G G G G G G S S G G G G G G G G G G G G G S S |
SSSSEEGGGGGGGGGGGGSSGGGGSSS	S S S S E E G G G G G G G G G G G G S S G G G G S S S |
SSSSEEGGGGGGGGSGGGGGGGSSSSSGGGGGGGGSSSSSSSSSSSSSSGGGGGGGGGGS	S S S S E E G G G G G G G G S G G G G G G G S S S S S G G G G G G G G S S S S S S S S S S S S S S G G G G G G G G G G S |
SSSSEEGGGSGGGGGGGGGGGGGGGGGSGGGEGGGGGEGGGGGSGGGGSS	S S S S E E G G G S G G G G G G G G G G G G G G G G G S G G G E G G G G G E G G G G G S G G G G S S |
SSSSEGGGGGGGGGGGGGGGSSS	S S S S E G G G G G G G G G G G G G G G S S S |
SSSSEGGGGGGGGGGSSGGGGGGGEEEGGGGGGGGGGGSS	S S S S E G G G G G G G G G G S S G G G G G G G E E E G G G G G G G G G G G S S |
SSSSGEEEEGEEGGSSSGGGSSSSGGGEEEEEEGSSSGGGGGGGSS	S S S S G E E E E G E E G G S S S G G G S S S S G G G E E E E E E G S S S G G G G G G G S S |
SSSSGEEEEGGGGGGGGEEEEEEGGGGGGSSGGGSSS	S S S S G E E E E G G G G G G G G E E E E E E G G G G G G S S G G G S S S |
SSSSGEEEEGSGGGGGSS	S S S S G E E E E G S G G G G G S S |
SSSSGEEEGGGGGGGGGGGGGGGGGGGGESGGGSGGGGGGSS	S S S S G E E E G G G G G G G G G G G G G G G G G G G G E S G G G S G G G G G G S S |
SSSSGGEEEEEEEEGGGGEEGGGGGGGEGGGGGGS	S S S S G G E E E E E E E E G G G G E E G G G G G G G E G G G G G G S |
SSSSGGEEEEEEGGSGGGGGGGGGGGGGGGGGGGSGGGGGGGGGGGGGSS	S S S S G G E E E E E E G G S G G G G G G G G G G G G G G G G G G G S G G G G G G G G G G G G G S S |
SSSSGGEEEEGGGGGGGGGGGSGGGGGGGGGGSSGGGGGGGGGGGGSSS	S S S S G G E E E E G G G G G G G G G G G S G G G G G G G G G G S S G G G G G G G G G G G G S S S |
SSSSGGEEEEGGSSSSGGGGGEEEEEGEEEEEESGGGGGGGGS	S S S S G G E E E E G G S S S S G G G G G E E E E E G E E E E E E S G G G G G G G G S |
SSSSGGEEGGGGGGGGGGSGGGGGGGGGGGGGGGGSSEEEEGGGGGGGGGSS	S S S S G G E E G G G G G G G G G G S G G G G G G G G G G G G G G G G S S E E E E G G G G G G G G G S S |
SSSSGGEEGGGGGSSSGGEEEEGGGGGGGGSS	S S S S G G E E G G G G G S S S G G E E E E G G G G G G G G S S |
SSSSGGEEGGSGGGGEEGGSSSGGGGGGSS	S S S S G G E E G G S G G G G E E G G S S S G G G G G G S S |
SSSSGGEESSSEEEEGGGGGGGESSSEEEGGSGEEEGGSGGGSGGGGSSSGGGGGGGGGSSS	S S S S G G E E S S S E E E E G G G G G G G E S S S E E E G G S G E E E G G S G G G S G G G G S S S G G G G G G G G G S S S |
SSSSGGEGGGEEEGGGGSS	S S S S G G E G G G E E E G G G G S S |
SSSSGGGEEEEEGGGGGGSSGGGGGGGGGGSSGGGGGGS	S S S S G G G E E E E E G G G G G G S S G G G G G G G G G G S S G G G G G G S |
SSSSGGGEEEEGGGGGGSSEEGGSSEEEGSGGGGGGGEEEGGGSSSSSGGSS	S S S S G G G E E E E G G G G G G S S E E G G S S E E E G S G G G G G G G E E E G G G S S S S S G G S S |
SSSSGGGEEEGGGGGGEEEEEEEEEGGGGGEEEGSS	S S S S G G G E E E G G G G G G E E E E E E E E E G G G G G E E E G S S |
SSSSGGGEEESSGGGGGSSGGGGEEEEEGGGGGGGGGGGGGGGGGGGGEEGGGSSGGGGGSGGGGGGSS	S S S S G G G E E E S S G G G G G S S G G G G E E E E E G G G G G G G G G G G G G G G G G G G G E E G G G S S G G G G G S G G G G G G S S |
SSSSGGGEEGEEEEEGGEEGGSS	S S S S G G G E E G E E E E E G G E E G G S S |
SSSSGGGEEGGGGGGGGGGGGGGGEGGGGGGGGSS	S S S S G G G E E G G G G G G G G G G G G G G G E G G G G G G G G S S |
SSSSGGGEEGGGGGGGGGGGGGGGGGGGGGSS	S S S S G G G E E G G G G G G G G G G G G G G G G G G G G G S S |
SSSSGGGEEGGGGGGGGS	S S S S G G G E E G G G G G G G G S |
SSSSGGGGEEEEEESSSSEEEEEEEGGGGGGGGGGGGGGGGGGGGGGGGGSS	S S S S G G G G E E E E E E S S S S E E E E E E E G G G G G G G G G G G G G G G G G G G G G G G G G S S |
SSSSGGGGEEEGGGGGGGSGGGGGGGGGGSS	S S S S G G G G E E E G G G G G G G S G G G G G G G G G G S S |
SSSSGGGGEEEGGGSSSGGGGGGGGGGGEEEGGGGGGGGSS	S S S S G G G G E E E G G G S S S G G G G G G G G G G G E E E G G G G G G G G S S |
SSSSGGGGEEGGGGGGGGGESSSSSSSGGGSSSGGGGGGGGGGSS	S S S S G G G G E E G G G G G G G G G E S S S S S S S G G G S S S G G G G G G G G G G S S |
SSSSGGGGGEESSGGGGGGGGGGGGSSGGGGSS	S S S S G G G G G E E S S G G G G G G G G G G G G S S G G G G S S |
SSSSGGGGGEGGGGGS	S S S S G G G G G E G G G G G S |
SSSSGGGGGGEEEGGEEEGEGGGGGGGGGGGGGGGGGSSSS	S S S S G G G G G G E E E G G E E E G E G G G G G G G G G G G G G G G G G S S S S |
SSSSGGGGGGEEEGGGGGGGGGGGGGGGGGGGGGGGGGGGGEEEGGGGGGGGSGGS	S S S S G G G G G G E E E G G G G G G G G G G G G G G G G G G G G G G G G G G G G E E E G G G G G G G G S G G S |
SSSSGGGGGGEEEGGGGGGGGGSGGGESSGGGGGSSSGGGGGGGGGGGGGGGG	S S S S G G G G G G E E E G G G G G G G G G S G G G E S S G G G G G S S S G G G G G G G G G G G G G G G G |
SSSSGGGGGGEEEGGGGGGGGSS	S S S S G G G G G G E E E G G G G G G G G S S |
SSSSGGGGGGEEGGEEEGGGGGGGGSGGGGGGGS	S S S S G G G G G G E E G G E E E G G G G G G G G S G G G G G G G S |
SSSSGGGGGGEEGGGGGGGGGGSS	S S S S G G G G G G E E G G G G G G G G G G S S |
SSSSGGGGGGEESSSSSSSSGGGGGGGGSS	S S S S G G G G G G E E S S S S S S S S G G G G G G G G S S |
SSSSGGGGGGEGGGGSS	S S S S G G G G G G E G G G G S S |
SSSSGGGGGGGEEEEEGGGGGGGGGGGGGGGGGGGGGGGGGGGGGGSGGGGGGGGEEEGGGGGGS	S S S S G G G G G G G E E E E E G G G G G G G G G G G G G G G G G G G G G G G G G G G G G G S G G G G G G G G E E E G G G G G G S |
SSSSGGGGGGGEEEEESSSSSSSEEGGS	S S S S G G G G G G G E E E E E S S S S S S S E E G G S |
SSSSGGGGGGGEEGGGGGEEGGGGGGGGGGGGGGS	S S S S G G G G G G G E E G G G G G E E G G G G G G G G G G G G G G S |
SSSSGGGGGGGEEGGGGGGS	S S S S G G G G G G G E E G G G G G G S |
SSSSGGGGGGGEESSSSSSSEEEEEESSGGGGGEEEEEEEEEEGGGSSSGGGGGGGGGGGGSS	S S S S G G G G G G G E E S S S S S S S E E E E E E S S G G G G G E E E E E E E E E E G G G S S S G G G G G G G G G G G G S S |
SSSSGGGGGGGGEEEEEGGGGGGGGGGGGGSS	S S S S G G G G G G G G E E E E E G G G G G G G G G G G G G S S |
SSSSGGGGGGGGEEEGGGGGGGGGGGGSS	S S S S G G G G G G G G E E E G G G G G G G G G G G G S S |
SSSSGGGGGGGGEEGGGGGGGGGGGGGGGGGSS	S S S S G G G G G G G G E E G G G G G G G G G G G G G G G G G S S |
SSSSGGGGGGGGGEEEEEGGGGGGGGGGGGGGGGGGGGGGGSS	S S S S G G G G G G G G G E E E E E G G G G G G G G G G G G G G G G G G G G G G G S S |
SSSSGGGGGGGGGEEEGGGGGGGEEGGGGGGGGGGS	S S S S G G G G G G G G G E E E G G G G G G G E E G G G G G G G G G G S |
SSSSGGGGGGGGGEEGEEEEGGGGGGSS	S S S S G G G G G G G G G E E G E E E E G G G G G G S S |
SSSSGGGGGGGGGEEGGGGGEEGGGSSGGGGGGGGGSGGGGGGGGS	S S S S G G G G G G G G G E E G G G G G E E G G G S S G G G G G G G G G S G G G G G G G G S |
SSSSGGGGGGGGGEEGGGGGGGGEEEESEESSGGGGGGGGSS	S S S S G G G G G G G G G E E G G G G G G G G E E E E S E E S S G G G G G G G G S S |
SSSSGGGGGGGGGEEGGGGGGGGSGGGGSS	S S S S G G G G G G G G G E E G G G G G G G G S G G G G S S |
SSSSGGGGGGGGGEGGGGGGEEEGGGGGGGGEEGGGSS	S S S S G G G G G G G G G E G G G G G G E E E G G G G G G G G E E G G G S S |
SSSSGGGGGGGGGGEEEEGEEEEEGGGGGGGGGGGSGGGGGSGGGGGGGGGGGSS	S S S S G G G G G G G G G G E E E E G E E E E E G G G G G G G G G G G S G G G G G S G G G G G G G G G G G S S |
SSSSGGGGGGGGGGEEGGSSSSSSSGGSGGGGGGGS	S S S S G G G G G G G G G G E E G G S S S S S S S G G S G G G G G G G S |
SSSSGGGGGGGGGGEESS	S S S S G G G G G G G G G G E E S S |
SSSSGGGGGGGGGGGEEEEGGGGGGGGGSSSS	S S S S G G G G G G G G G G G E E E E G G G G G G G G G S S S S |
SSSSGGGGGGGGGGGGEEEEESGGGGGGSGGGSS	S S S S G G G G G G G G G G G G E E E E E S G G G G G G S G G G S S |
SSSSGGGGGGGGGGGGEEEGGGGGGGGS	S S S S G G G G G G G G G G G G E E E G G G G G G G G S |
SSSSGGGGGGGGGGGGGEGGGSS	S S S S G G G G G G G G G G G G G E G G G S S |
SSSSGGGGGGGGGGGGGGEEGGGGGEEEGGGSSSSSSSGGGGS	S S S S G G G G G G G G G G G G G G E E G G G G G E E E G G G S S S S S S S G G G G S |
SSSSGGGGGGGGGGGGGGGEEGGGGGS	S S S S G G G G G G G G G G G G G G G E E G G G G G S |
SSSSGGGGGGGGGGGGGGGGGGGEEEEEGGSGGGGGGGGGGGGSS	S S S S G G G G G G G G G G G G G G G G G G G E E E E E G G S G G G G G G G G G G G G S S |
SSSSGGGGGGGGGGGGGGGGGGGEGGGSS	S S S S G G G G G G G G G G G G G G G G G G G E G G G S S |
SSSSGGGGGGGGGGGGGGGGGGGGEEEEEGEEEESSSSSEEEGGGGSS	S S S S G G G G G G G G G G G G G G G G G G G G E E E E E G E E E E S S S S S E E E G G G G S S |
SSSSGGGGGGGGGGGGGGGGGGGGEEEGGEEEEEGGGGGGGGGGGGGGGGGGGSS	S S S S G G G G G G G G G G G G G G G G G G G G E E E G G E E E E E G G G G G G G G G G G G G G G G G G G S S |
SSSSGGGGGGGGGGGGGGGGGGGGEEGGGGS	S S S S G G G G G G G G G G G G G G G G G G G G E E G G G G S |
SSSSGGGGGGGGGGGGGGGGGGGGGEEEGGGGGGS	S S S S G G G G G G G G G G G G G G G G G G G G G E E E G G G G G G S |
SSSSGGGGGGGGGGGGGGGGGGGGGEEGGGGGGSSSSSSSGGGGGGEEEEGEEESGGGGSS	S S S S G G G G G G G G G G G G G G G G G G G G G E E G G G G G G S S S S S S S G G G G G G E E E E G E E E S G G G G S S |
SSSSGGGGGGGGGGGGGGGGGGGGGESGGGGGGSS	S S S S G G G G G G G G G G G G G G G G G G G G G E S G G G G G G S S |
SSSSGGGGGGGGGGGGGGGGGGGGGGGGEGGSSS	S S S S G G G G G G G G G G G G G G G G G G G G G G G G E G G S S S |
SSSSGGGGGGGGGGGGGGGGGGGGGGGGGGGSSGGGGGGSSSSSEEGGGGGGSS	S S S S G G G G G G G G G G G G G G G G G G G G G G G G G G G S S G G G G G G S S S S S E E G G G G G G S S |
SSSSGGGGGGGGGGGGGGGGGGGGGSSSGGGGGEESEEEEEEGGGGGGSS	S S S S G G G G G G G G G G G G G G G G G G G G G S S S G G G G G E E S E E E E E E G G G G G G S S |
SSSSGGGGGGGGGGGGGGGGGGSEEGGGGGGGGGGSS	S S S S G G G G G G G G G G G G G G G G G G S E E G G G G G G G G G G S S |
SSSSGGGGGGGGGGGGGGGGGSGGGSEEEGGGSS	S S S S G G G G G G G G G G G G G G G G G S G G G S E E E G G G S S |
SSSSGGGGGGGGGGGGGGGSEEEEGGGGGGGGSS	S S S S G G G G G G G G G G G G G G G S E E E E G G G G G G G G S S |
SSSSGGGGGGGGGGGGGGSEEEGGGGSSSGGEEEESSSSEEEGGGGGSSSSSS	S S S S G G G G G G G G G G G G G G S E E E G G G G S S S G G E E E E S S S S E E E G G G G G S S S S S S |
SSSSGGGGGGGGGGGGGGSEESSSSSGGGGGGSGGGGGGSS	S S S S G G G G G G G G G G G G G G S E E S S S S S G G G G G G S G G G G G G S S |
SSSSGGGGGGGGGGGGGSEEEEGGGGGSSSSSS	S S S S G G G G G G G G G G G G G S E E E E G G G G G S S S S S S |
SSSSGGGGGGGGGGGGGSGGGGGEEEESSEEEEEESSSGGGGGGGGGS	S S S S G G G G G G G G G G G G G S G G G G G E E E E S S E E E E E E S S S G G G G G G G G G S |
SSSSGGGGGGGGGGGGGSSSGGGGGSEEGGGGGGGGGGGGGGSGGGGGGGGGGGGGGGGGGS	S S S S G G G G G G G G G G G G G S S S G G G G G S E E G G G G G G G G G G G G G G S G G G G G G G G G G G G G G G G G G S |
SSSSGGGGGGGGGGGSGGEEGGGGGSS	S S S S G G G G G G G G G G G S G G E E G G G G G S S |
SSSSGGGGGGGGGGGSGGSSSGGSSSSEEEEEEEEEESEGGGSGGGGSSSSSEEEEGGGGS	S S S S G G G G G G G G G G G S G G S S S G G S S S S E E E E E E E E E E S E G G G S G G G G S S S S S E E E E G G G G S |
SSSSGGGGGGGGGGGSSGGGSGGGGGGGGGGGGEGGGGGGGGGGGGSS	S S S S G G G G G G G G G G G S S G G G S G G G G G G G G G G G G E G G G G G G G G G G G G S S |
SSSSGGGGGGGGGGSEGGGGGGGGGGGSS	S S S S G G G G G G G G G G S E G G G G G G G G G G G S S |
SSSSGGGGGGGGGGSGGEEGGGGGGGGGGGGGGGGGGSSGGGGGGGGGGGGGGGGSS	S S S S G G G G G G G G G G S G G E E G G G G G G G G G G G G G G G G G G S S G G G G G G G G G G G G G G G G S S |
SSSSGGGGGGGGGGSSGGGGGGGGGGGEEGGGGGGGGGGSS	S S S S G G G G G G G G G G S S G G G G G G G G G G G E E G G G G G G G G G G S S |
SSSSGGGGGGGGGGSSSGGGSSEEEEEGGGGSS	S S S S G G G G G G G G G G S S S G G G S S E E E E E G G G G S S |
SSSSGGGGGGGGSGGGGGGGGGGGGEEGGGGGSS	S S S S G G G G G G G G S G G G G G G G G G G G G E E G G G G G S S |
SSSSGGGGGGGGSGGGGGGGGGGGGGGGGEESGGSS	S S S S G G G G G G G G S G G G G G G G G G G G G G G G G E E S G G S S |
SSSSGGGGGGGGSGGGGGGGGGGGGGGSGSSSGGGGGEEGGGGS	S S S S G G G G G G G G S G G G G G G G G G G G G G G S G S S S G G G G G E E G G G G S |
SSSSGGGGGGGSGGGGGGGGEEGGGSSGGGGGGGGGS	S S S S G G G G G G G S G G G G G G G G E E G G G S S G G G G G G G G G S |
SSSSGGGGGGGSSGGGGGSEESSSSGGSSSSSGGGGGGGGGGGS	S S S S G G G G G G G S S G G G G G S E E S S S S G G S S S S S G G G G G G G G G G G S |
SSSSGGGGGGSSGGGGGGEEEGGGGGGGGSS	S S S S G G G G G G S S G G G G G G E E E G G G G G G G G S S |
SSSSGGGGGSGGGGSGGGEESSSSSSSSSSSSSEEESSEEEEGGGEEEEEEEGGSSEEEGGSGGGSS	S S S S G G G G G S G G G G S G G G E E S S S S S S S S S S S S S E E E S S E E E E G G G E E E E E E E G G S S E E E G G S G G G S S |
SSSSGGGGGSSGGEEGGGGSS	S S S S G G G G G S S G G E E G G G G S S |
SSSSGGGGSGGGGGGGGGGGGSSSSSEEEGGGGSS	S S S S G G G G S G G G G G G G G G G G G S S S S S E E E G G G G S S |
SSSSGGGGSGGGGGSEEGGGGGGGGGGS	S S S S G G G G S G G G G G S E E G G G G G G G G G G S |
SSSSGGGGSSGGGGGGGEGGGGSS	S S S S G G G G S S G G G G G G G E G G G G S S |
SSSSGGGSEEEEEEGGGGGGGGGGGGGSS	S S S S G G G S E E E E E E G G G G G G G G G G G G G S S |
SSSSGGGSEEGGGGGGGGGGGGGGSS	S S S S G G G S E E G G G G G G G G G G G G G G S S |
SSSSGGGSGGGGGGSGGGGGGGSGGGGGGGSGGGGSGGGGGGGSSSEEEEEGGGGSS	S S S S G G G S G G G G G G S G G G G G G G S G G G G G G G S G G G G S G G G G G G G S S S E E E E E G G G G S S |
SSSSGGGSGGGGGSGGSEGGGGGGGGGGGGGGGGSS	S S S S G G G S G G G G G S G G S E G G G G G G G G G G G G G G G G S S |
SSSSGGGSSGGGGGGGGSGGGGGGEGGGGGGGGGGGGGGGGGGGGGGGGGGGGSS	S S S S G G G S S G G G G G G G G S G G G G G G E G G G G G G G G G G G G G G G G G G G G G G G G G G G G S S |
SSSSGGGSSSGGGEEGGGGGSSSSSSSSGGGGGGSS	S S S S G G G S S S G G G E E G G G G G S S S S S S S S G G G G G G S S |
SSSSSEEEEEGGGGGGGGGGGEEGSS	S S S S S E E E E E G G G G G G G G G G G E E G S S |
SSSSSEEEEESSEEEEEGGGGGGGGGGGSGGGGGGGGGSGGGGGGGGGGGGSSS	S S S S S E E E E E S S E E E E E G G G G G G G G G G G S G G G G G G G G G S G G G G G G G G G G G G S S S |
SSSSSEEGGGGGGGGSGGGGGGGGSSGGGGGGGGGGGGGGGGGGGGGGGGGGGGGGGGGGGGGGGSS	S S S S S E E G G G G G G G G S G G G G G G G G S S G G G G G G G G G G G G G G G G G G G G G G G G G G G G G G G G G G G G G G G S S |
SSSSSEEGGGGGGGGSSGGGGGEEESSEEESEEEESSGGGSS	S S S S S E E G G G G G G G G S S G G G G G E E E S S E E E S E E E E S S G G G S S |
SSSSSEEGGGGSSGGGGGGGGGGEEGGGGGGSSS	S S S S S E E G G G G S S G G G G G G G G G G E E G G G G G G S S S |
SSSSSEGGGGGGGGGGGGGGGGGGGGGGGGGSGGGGGGGGGGGGGGGS	S S S S S E G G G G G G G G G G G G G G G G G G G G G G G G G S G G G G G G G G G G G G G G G S |
SSSSSEGGSSSGGGGGGGGGGGSSSGGGGGGGGGGGGGGGS	S S S S S E G G S S S G G G G G G G G G G G S S S G G G G G G G G G G G G G G G S |
SSSSSGEEEEGGGGGGGGGSS	S S S S S G E E E E G G G G G G G G G S S |
SSSSSGEEGGGGGGGSGGGGS	S S S S S G E E G G G G G G G S G G G G S |
SSSSSGGEEEGGGGGGSS	S S S S S G G E E E G G G G G G S S |
SSSSSGGEEESSSSSSESGGGGSEEEEEGGGSGGGSS	S S S S S G G E E E S S S S S S E S G G G G S E E E E E G G G S G G G S S |
SSSSSGGEEGGGGGGGGGGGGGSSS	S S S S S G G E E G G G G G G G G G G G G G S S S |
SSSSSGGEEGGSGGGEGGSSGGGGGGGGGGGGGGG	S S S S S G G E E G G S G G G E G G S S G G G G G G G G G G G G G G G |
SSSSSGGGEEEEGGSGGGSSSGGSSSSSSSSSSGGGGGGGGGGGSSSGGGGGSS	S S S S S G G G E E E E G G S G G G S S S G G S S S S S S S S S S G G G G G G G G G G G S S S G G G G G S S |
SSSSSGGGEEEGGGGGSSGGGGEEESEEGGGSS	S S S S S G G G E E E G G G G G S S G G G G E E E S E E G G G S S |
SSSSSGGGGGEEEEGGGGGGEGEGGGGGGGGGGGGS	S S S S S G G G G G E E E E G G G G G G E G E G G G G G G G G G G G G S |
SSSSSGGGGGGEEEGGGSGGGGGGGGSSS	S S S S S G G G G G G E E E G G G S G G G G G G G G S S S |
SSSSSGGGGGGGEEESSSSSSSGGEEEESSSEEEEESSSSSSSSSSSSSSSSSSSSSGGGGGSSSSSGGGGGGGGGSGGGGGGGGSSSSSSGGGGGSSSSSS	S S S S S G G G G G G G E E E S S S S S S S G G E E E E S S S E E E E E S S S S S S S S S S S S S S S S S S S S S G G G G G S S S S S G G G G G G G G G S G G G G G G G G S S S S S S G G G G G S S S S S S |
SSSSSGGGGGGGEESSGGGGGGGGGSS	S S S S S G G G G G G G E E S S G G G G G G G G G S S |
SSSSSGGGGGGGGGEEEEGGGGGGGGGGS	S S S S S G G G G G G G G G E E E E G G G G G G G G G G S |
SSSSSGGGGGGGGGGGGGEEEGGGGGGGGGGGSS	S S S S S G G G G G G G G G G G G G E E E G G G G G G G G G G G S S |
SSSSSGGGGGGGGGGGGGGGGGGGGGGEEEGGSSEEEEEGGGGGGGSS	S S S S S G G G G G G G G G G G G G G G G G G G G G G E E E G G S S E E E E E G G G G G G G S S |
SSSSSGGGGGGGGGGGGGGGGGGGSEEEEGGGGGGGGGGGGGGGGGSGGGGGGSS	S S S S S G G G G G G G G G G G G G G G G G G G S E E E E G G G G G G G G G G G G G G G G G S G G G G G G S S |
SSSSSGGGGGGGGGGGGGGGGGS	S S S S S G G G G G G G G G G G G G G G G G S |
SSSSSGGGGGGGGGGGGGGSEEEGGGGGSS	S S S S S G G G G G G G G G G G G G G S E E E G G G G G S S |
SSSSSGGGGGGGGGGGGGGSSGGGGGGGGGGGSGGGGGGGGEGGGGGS	S S S S S G G G G G G G G G G G G G G S S G G G G G G G G G G G S G G G G G G G G E G G G G G S |
SSSSSGGGGGGGGGGGGSGGGGGSGGEEGGGGGGGGGGSSS	S S S S S G G G G G G G G G G G G S G G G G G S G G E E G G G G G G G G G G S S S |
SSSSSGGGGGGGGSGGGGGGEEGGGGGGGGGGGGGGGGSS	S S S S S G G G G G G G G S G G G G G G E E G G G G G G G G G G G G G G G G S S |
SSSSSGGGGSEEGGGEEEEGGGGGGEEEEGGGGSS	S S S S S G G G G S E E G G G E E E E G G G G G G E E E E G G G G S S |
SSSSSGGGGSGGGGGGEEEGGGEEGGSGGGGGSSSS	S S S S S G G G G S G G G G G G E E E G G G E E G G S G G G G G S S S S |
SSSSSGGGGSSSEGGGGSGGGGGGGGGGGGSS	S S S S S G G G G S S S E G G G G S G G G G G G G G G G G G S S |
SSSSSGGGGSSSSSSGGGGGSSSSSEEEEESSGGGGEEEGGGGGGGGGGGSSSGGSEEEEGGGGGGGSS	S S S S S G G G G S S S S S S G G G G G S S S S S E E E E E S S G G G G E E E G G G G G G G G G G G S S S G G S E E E E G G G G G G G S S |
SSSSSGGGSGGGGGGEEEEEEEESGGGGGGSS	S S S S S G G G S G G G G G G E E E E E E E E S G G G G G G S S |
SSSSSGGGSSGGEEESGGGGGGGGGGGGGGGGGGGGGGGGGGGGGGGGGGGSS	S S S S S G G G S S G G E E E S G G G G G G G G G G G G G G G G G G G G G G G G G G G G G G G G G G G S S |
SSSSSGGSGGGGGGSSSGGEEEEEEGGGGGGGGSGGGGSS	S S S S S G G S G G G G G G S S S G G E E E E E E G G G G G G G G S G G G G S S |
SSSSSSEEEEEEGEEEGGGSSGGGGGGGGSGGGGGGGSGGGGSGGGGGGGGGGSS	S S S S S S E E E E E E G E E E G G G S S G G G G G G G G S G G G G G G G S G G G G S G G G G G G G G G G S S |
SSSSSSEEEEEEGGGGGGGGGGGGGGGGGGGSSSSSSSSSGEESS	S S S S S S E E E E E E G G G G G G G G G G G G G G G G G G G S S S S S S S S S G E E S S |
SSSSSSEEEEESGGGGGGGGGGGGGGSSGGGGGGGGGGSGGGGGS	S S S S S S E E E E E S G G G G G G G G G G G G G G S S G G G G G G G G G G S G G G G G S |
SSSSSSEEEGGEEEESSEEESGGGGGGGGSSSSSSGGGGEEESSSGGGGGGGSS	S S S S S S E E E G G E E E E S S E E E S G G G G G G G G S S S S S S G G G G E E E S S S G G G G G G G S S |
SSSSSSEEGGGGGGGGEEEGGGGGGGGGGSS	S S S S S S E E G G G G G G G G E E E G G G G G G G G G G S S |
SSSSSSEEGGGGGSSGGGSGGGGGGGGGGGGGGGGGSEGGGGGGGSS	S S S S S S E E G G G G G S S G G G S G G G G G G G G G G G G G G G G G S E G G G G G G G S S |
SSSSSSEESGEEEEEEEEEGGGGGGGGGGGGGGSS	S S S S S S E E S G E E E E E E E E E G G G G G G G G G G G G G G S S |
SSSSSSGEEESGSGGGGGGSSSGGGGGGGGGGGGGGGGGGSSS	S S S S S S G E E E S G S G G G G G G S S S G G G G G G G G G G G G G G G G G G S S S |
SSSSSSGGEGGSSEEGEGSGGGGGGGSSSS	S S S S S S G G E G G S S E E G E G S G G G G G G G S S S S |
SSSSSSGGGEEGGGGGGGGGGGGGGGGGGGGGGGGGGGGGGSS	S S S S S S G G G E E G G G G G G G G G G G G G G G G G G G G G G G G G G G G G G S S |
SSSSSSGGGGEEEEGGGGGGGSGGGGGGGSS	S S S S S S G G G G E E E E G G G G G G G S G G G G G G G S S |
SSSSSSGGGGEEGGSSSGGGGSGGGGGGSGGGGGGGSS	S S S S S S G G G G E E G G S S S G G G G S G G G G G G S G G G G G G G S S |
SSSSSSGGGGGGGEEGGGGGGGGGGGGGGGGGSSGGGGGGGGGGS	S S S S S S G G G G G G G E E G G G G G G G G G G G G G G G G G S S G G G G G G G G G G S |
SSSSSSGGGGGSSSGGGGGGGGEESSS	S S S S S S G G G G G S S S G G G G G G G G E E S S S |
SSSSSSGGGSGGSGGGGGGSSSGGGGGGGGSSSSGGGGGGGSSSSGGGGSSSGGGGGGGGSSSSGGGGSEESGGGSS	S S S S S S G G G S G G S G G G G G G S S S G G G G G G G G S S S S G G G G G G G S S S S G G G G S S S G G G G G G G G S S S S G G G G S E E S G G G S S |
SSSSSSSEEEESSEESSSSGGGGGGSSSSSSSGGGGGSGGEEEESSSEEGGGSGGGSGGGGGGGGGGGGGGGGGSSSSSSSSSGGGGGGGSS	S S S S S S S E E E E S S E E S S S S G G G G G G S S S S S S S G G G G G S G G E E E E S S S E E G G G S G G G S G G G G G G G G G G G G G G G G G S S S S S S S S S G G G G G G G S S |
SSSSSSSEEGGGGGGGGSGGGGSSGGGGGGSS	S S S S S S S E E G G G G G G G G S G G G G S S G G G G G G S S |
SSSSSSSESEEGGGGGGGGGGGGGGGGGGGGGGGSSGGGGGGGGGGGGGGGGGGS	S S S S S S S E S E E G G G G G G G G G G G G G G G G G G G G G G G S S G G G G G G G G G G G G G G G G G G S |
SSSSSSSGGGGGGGGGEEEEEEEGGGS	S S S S S S S G G G G G G G G G E E E E E E E G G G S |
SSSSSSSGGGGGSGGGGSGGGSSSGGGGGGSEEGGSGGGSGGGGGGGGGGSS	S S S S S S S G G G G G S G G G G S G G G S S S G G G G G G S E E G G S G G G S G G G G G G G G G G S S |
SSSSSSSGGGGSGSEEGGGGGGSS	S S S S S S S G G G G S G S E E G G G G G G S S |
SSSSSSSSSSEEGGGSGGGSGGGGGGGGGGGGGGSSSSSSGGGGGGGGGGGGGGGGSSSSS	S S S S S S S S S S E E G G G S G G G S G G G G G G G G G G G G G G S S S S S S G G G G G G G G G G G G G G G G S S S S S |
SSSSSSSSSSSEEEEGGSSSSGGGGGGSS	S S S S S S S S S S S E E E E G G S S S S G G G G G G S S |
SSSSSSSSSSSGGGGGGGGGGGGGGGGGSS	S S S S S S S S S S S G G G G G G G G G G G G G G G G G S S |
